id_x,movie,production_budget,domestic_gross,worldwide_gross,total_gross,net_revenue,original_language,popularity,release_date_y,vote_average,vote_count,start_year,runtime_minutes,genres,imdb_averagerating,imdb_numvotes
1,Avatar,425000000,760507625,2776345279,3536852904,3111852904,en,26.526,2009-12-18,7.4,18676,2011,93.0,Horror,6.1,43
2,Pirates of the Caribbean: On Stranger Tides,410600000,241063875,1045663875,1286727750,876127750,en,30.579,2011-05-20,6.4,8571,2011,136.0,"Action,Adventure,Fantasy",6.6,447624
4,Avengers: Age of Ultron,330600000,459005868,1403013963,1862019831,1531419831,en,44.383,2015-05-01,7.3,13457,2015,141.0,"Action,Adventure,Sci-Fi",7.3,665594
7,Avengers: Infinity War,300000000,678815482,2048134200,2726949682,2426949682,en,80.773,2018-04-27,8.3,13948,2018,149.0,"Action,Adventure,Sci-Fi",8.5,670926
9,Justice League,300000000,229024295,655945209,884969504,584969504,en,34.953,2017-11-17,6.2,7510,2017,120.0,"Action,Adventure,Fantasy",6.5,329135
10,Spectre,300000000,200074175,879620923,1079695098,779695098,en,30.318,2015-11-06,6.4,6719,2015,148.0,"Action,Adventure,Thriller",6.8,352504
11,The Dark Knight Rises,275000000,448139099,1084439099,1532578198,1257578198,en,26.22,2012-07-20,7.7,13933,2012,164.0,"Action,Thriller",8.4,1387769
12,Solo: A Star Wars Story,275000000,213767512,393151347,606918859,331918859,en,29.502,2018-05-25,6.6,3838,2018,135.0,"Action,Adventure,Fantasy",7.0,226243
13,The Lone Ranger,275000000,89302115,260002115,349304230,74304230,en,12.482,2013-07-03,6.0,3789,2013,150.0,"Action,Adventure,Western",6.4,208827
14,John Carter,275000000,73058679,282778100,355836779,80836779,en,18.549,2012-03-09,6.1,3338,2012,132.0,"Action,Adventure,Sci-Fi",6.6,241792
15,Tangled,260000000,200821936,586477240,787299176,527299176,en,21.511,2010-11-24,7.5,6407,2010,100.0,"Adventure,Animation,Comedy",7.8,366366
17,Captain America: Civil War,250000000,408084349,1140069413,1548153762,1298153762,en,39.137,2016-05-06,7.4,14000,2016,147.0,"Action,Adventure,Sci-Fi",7.8,583507
18,Batman v Superman: Dawn of Justice,250000000,330360194,867500281,1197860475,947860475,en,28.088,2016-03-25,5.8,11991,2016,151.0,"Action,Adventure,Fantasy",6.5,576909
19,The Hobbit: An Unexpected Journey,250000000,303003568,1017003568,1320007136,1070007136,en,26.939,2012-12-14,7.2,12076,2012,169.0,"Adventure,Family,Fantasy",7.9,719629
21,The Hobbit: The Desolation of Smaug,250000000,258366855,960366855,1218733710,968733710,en,21.275,2013-12-13,7.6,7739,2013,161.0,"Adventure,Fantasy",7.8,565563
22,The Hobbit: The Battle of the Five Armies,250000000,255119788,945577621,1200697409,950697409,en,53.783,2014-12-17,7.3,8392,2014,144.0,"Adventure,Fantasy",7.4,438621
23,The Fate of the Furious,250000000,225764765,1234846267,1460611032,1210611032,en,28.668,2017-04-14,6.9,6335,2017,136.0,"Action,Crime,Thriller",6.7,179774
25,Pirates of the Caribbean: Dead Men Tell No Tales,230000000,172558876,788241137,960800013,730800013,en,28.101,2017-05-26,6.6,6931,2017,129.0,"Action,Adventure,Fantasy",6.6,228592
27,The Avengers,225000000,623279547,1517935897,2141215444,1916215444,en,50.289,2012-05-04,7.6,19673,2012,143.0,"Action,Adventure,Sci-Fi",8.1,1183655
29,Man of Steel,225000000,291045518,667999518,959045036,734045036,en,27.667,2013-06-14,6.5,9758,2013,143.0,"Action,Adventure,Sci-Fi",7.1,647288
31,The Amazing Spider-Man,220000000,262030663,757890267,1019920930,799920930,en,24.391,2012-07-04,6.5,10411,2012,136.0,"Action,Adventure,Sci-Fi",7.0,525632
32,Battleship,220000000,65233400,313477717,378711117,158711117,en,21.742,2012-05-18,5.6,3240,2012,131.0,"Action,Adventure,Sci-Fi",5.8,225342
33,Transformers: The Last Knight,217000000,130168683,602893340,733062023,516062023,en,24.258,2017-06-21,6.0,3255,2017,154.0,"Action,Adventure,Sci-Fi",5.2,119007
34,Jurassic World,215000000,652270625,1648854864,2301125489,2086125489,en,20.709,2015-06-12,6.6,14056,2015,124.0,"Action,Adventure,Sci-Fi",7.0,539338
35,Men in Black 3,215000000,179020854,654213485,833234339,618234339,en,26.176,2012-05-25,6.4,6398,2012,106.0,"Action,Adventure,Comedy",6.8,309879
37,Transformers: Age of Extinction,210000000,245439076,1104039076,1349478152,1139478152,en,20.961,2014-06-27,5.8,4805,2014,165.0,"Action,Adventure,Sci-Fi",5.7,283486
39,Robin Hood,210000000,105487148,322459006,427946154,217946154,en,15.444,2010-05-14,6.3,2569,2010,140.0,"Action,Adventure,Drama",6.6,239480
42,Black Panther,200000000,700059566,1348258224,2048317790,1848317790,en,2.058,2011-01-18,5.1,11,2018,134.0,"Action,Adventure,Sci-Fi",7.3,516148
44,Incredibles 2,200000000,608581744,1242520711,1851102455,1651102455,en,36.286,2018-06-15,7.6,6354,2018,118.0,"Action,Adventure,Animation",7.7,203510
45,Rogue One: A Star Wars Story,200000000,532177324,1049102856,1581280180,1381280180,en,21.401,2016-12-16,7.5,9296,2016,133.0,"Action,Adventure,Sci-Fi",7.8,478592
46,Finding Dory,200000000,486295561,1021215193,1507510754,1307510754,en,15.393,2016-06-17,7.0,7845,2016,97.0,"Adventure,Animation,Comedy",7.3,213542
47,Toy Story 3,200000000,415004880,1068879522,1483884402,1283884402,en,24.445,2010-06-17,7.7,8340,2010,103.0,"Adventure,Animation,Comedy",8.3,682218
48,Iron Man 3,200000000,408992272,1215392272,1624384544,1424384544,en,32.093,2013-05-03,6.9,14155,2013,130.0,"Action,Adventure,Sci-Fi",7.2,692794
51,Alice in Wonderland,200000000,334191110,1025491110,1359682220,1159682220,en,22.02,2010-03-05,6.6,8713,2010,108.0,"Adventure,Family,Fantasy",6.5,358813
52,Skyfall,200000000,304360277,1110526981,1414887258,1214887258,en,19.27,2012-11-09,7.1,10441,2012,143.0,"Action,Adventure,Thriller",7.8,592221
53,Monsters University,200000000,268488329,743588329,1012076658,812076658,en,20.33,2013-06-21,7.0,6362,2013,104.0,"Adventure,Animation,Comedy",7.3,291887
54,Oz the Great and Powerful,200000000,234770996,490359051,725130047,525130047,en,13.377,2013-03-08,5.8,4829,2013,130.0,"Adventure,Family,Fantasy",6.3,192045
55,X-Men: Days of Future Past,200000000,233921534,747862775,981784309,781784309,en,41.867,2014-05-23,7.5,10062,2014,132.0,"Action,Adventure,Sci-Fi",8.0,620079
56,The Amazing Spider-Man 2,200000000,202853933,708996336,911850269,711850269,en,20.847,2014-05-02,6.4,7220,2014,142.0,"Action,Adventure,Sci-Fi",6.6,388363
57,Cars 2,200000000,191450875,560155383,751606258,551606258,en,23.498,2011-06-16,5.9,4058,2011,106.0,"Adventure,Animation,Comedy",6.2,138914
60,Fantastic Beasts: The Crimes of Grindelwald,200000000,159555901,652220086,811775987,611775987,en,48.508,2018-11-16,6.9,4870,2018,134.0,"Adventure,Family,Fantasy",6.6,163151
62,Green Lantern,200000000,116601172,219535492,336136664,136136664,en,17.257,2011-06-17,5.1,4290,2011,114.0,"Action,Adventure,Sci-Fi",5.5,252281
64,Transformers: Dark of the Moon,195000000,352390543,1123790543,1476181086,1281181086,en,5.339,2011-06-28,6.1,4961,2011,154.0,"Action,Adventure,Sci-Fi",6.2,366409
65,The Mummy,195000000,80101125,409953905,490055030,295055030,en,18.53,2017-06-09,5.5,4391,2017,110.0,"Action,Adventure,Fantasy",5.5,154345
66,Jack the Giant Slayer,195000000,65187603,197687603,262875206,67875206,en,12.773,2013-03-01,5.6,3403,2013,114.0,"Adventure,Fantasy",6.3,123127
67,Furious 7,190000000,353007020,1518722794,1871729814,1681729814,en,20.396,2015-04-03,7.3,6538,2015,137.0,"Action,Crime,Thriller",7.2,335074
68,Star Trek Into Darkness,190000000,228778661,467381584,696160245,506160245,en,20.487,2013-05-16,7.4,6182,2013,132.0,"Action,Adventure,Sci-Fi",7.7,445535
69,World War Z,190000000,202359711,531514650,733874361,543874361,en,14.582,2013-06-21,6.7,9132,2013,116.0,"Action,Adventure,Horror",7.0,553751
70,The Great Gatsby,190000000,144840419,351040419,495880838,305880838,en,15.397,2013-05-10,7.4,7120,2013,143.0,"Drama,Romance",7.3,433165
72,Pacific Rim,190000000,101802906,411002906,512805812,322805812,en,16.759,2013-07-12,6.8,7632,2013,131.0,"Action,Adventure,Sci-Fi",6.9,443667
73,The Good Dinosaur,187500000,123087120,333771037,456858157,269358157,en,17.675,2015-11-25,6.7,3135,2015,93.0,"Adventure,Animation,Comedy",6.7,91465
77,Brave,185000000,237282182,554606532,791888714,606888714,th,0.6,2010-01-19,5.0,1,2012,93.0,"Adventure,Animation,Comedy",7.1,338728
78,Kong: Skull Island,185000000,168052812,561072059,729124871,544124871,en,29.388,2017-03-10,6.3,6054,2017,118.0,"Action,Adventure,Fantasy",6.6,237720
79,Star Trek Beyond,185000000,158848340,335802233,494650573,309650573,en,19.142,2016-07-22,6.7,4275,2016,122.0,"Action,Adventure,Sci-Fi",7.1,209844
80,Blade Runner 2049,185000000,92054159,259357408,351411567,166411567,en,48.571,2017-10-06,7.4,6679,2017,164.0,"Drama,Mystery,Sci-Fi",8.0,376241
82,Thor: Ragnarok,180000000,315058289,846980024,1162038313,982038313,en,43.45,2017-11-03,7.5,11380,2017,130.0,"Action,Adventure,Comedy",7.9,482995
84,Maleficent,180000000,241407328,758536735,999944063,819944063,en,19.274,2014-05-30,7.0,8143,2014,97.0,"Action,Adventure,Family",7.0,305832
85,Fantastic Beasts and Where to Find Them,180000000,234037575,802402853,1036440428,856440428,en,28.563,2016-11-18,7.4,12152,2016,132.0,"Adventure,Family,Fantasy",7.3,365353
88,The Legend of Tarzan,180000000,126643061,348902025,475545086,295545086,en,14.797,2016-07-01,5.8,4102,2016,110.0,"Action,Adventure,Drama",6.3,150154
89,Hugo,180000000,73864507,180047784,253912291,73912291,en,12.936,2011-11-23,7.1,4124,2011,126.0,"Adventure,Drama,Family",7.5,284869
90,Valerian and the City of a Thousand Planets,180000000,40479370,215098356,255577726,75577726,en,24.003,2017-07-21,6.6,4149,2017,137.0,"Action,Adventure,Fantasy",6.5,139792
91,Jupiter Ascending,179000000,47482519,181982519,229465038,50465038,en,24.058,2015-02-27,5.3,4401,2015,127.0,"Action,Adventure,Sci-Fi",5.3,166327
93,X-Men: Apocalypse,178000000,155442489,542537546,697980035,519980035,en,39.293,2016-05-27,6.5,8348,2016,144.0,"Action,Adventure,Sci-Fi",7.0,356556
94,The Meg,178000000,145443742,529530715,674974457,496974457,en,31.397,2018-08-10,5.9,2896,2018,113.0,"Action,Horror,Sci-Fi",5.7,114042
95,Edge of Tomorrow,178000000,100206256,370541256,470747512,292747512,en,19.753,2014-06-06,7.6,8047,2014,113.0,"Action,Sci-Fi",7.9,546284
97,The Jungle Book,175000000,364001123,962854547,1326855670,1151855670,en,20.129,2016-04-15,6.8,5257,2014,64.0,Animation,7.0,59
98,Inside Out,175000000,356461711,854235992,1210697703,1035697703,en,4.758,2011-09-27,4.4,18,2011,93.0,"Crime,Drama",4.6,1566
99,Spider-Man: Homecoming,175000000,334201140,880166350,1214367490,1039367490,en,46.775,2017-07-07,7.4,11585,2017,133.0,"Action,Adventure,Sci-Fi",7.5,426302
100,Suicide Squad,175000000,325100054,746059887,1071159941,896159941,en,16.53,2016-08-05,5.9,13533,2016,123.0,"Action,Adventure,Fantasy",6.0,533039
2,Coco,175000000,209726015,798008101,1007734116,832734116,en,25.961,2017-11-22,8.2,8669,2017,105.0,"Adventure,Animation,Comedy",8.4,277194
5,Cars 3,175000000,152901115,383541369,536442484,361442484,en,18.427,2017-06-16,6.7,2596,2017,102.0,"Adventure,Animation,Comedy",6.8,59408
11,King Arthur: Legend of the Sword,175000000,39175066,139630336,178805402,3805402,en,21.793,2017-05-12,6.5,3305,2017,126.0,"Action,Adventure,Drama",6.8,169054
12,47 Ronin,175000000,38362475,151716815,190079290,15079290,en,25.049,2013-12-25,6.0,2080,2013,128.0,"Action,Adventure,Drama",6.3,135754
13,Jurassic World: Fallen Kingdom,170000000,417719760,1305772799,1723492559,1553492559,en,34.958,2018-06-22,6.5,5995,2018,128.0,"Action,Adventure,Sci-Fi",6.2,219125
14,Guardians of the Galaxy,170000000,333172112,770867516,1104039628,934039628,en,49.606,2014-08-01,7.9,17958,2014,121.0,"Action,Adventure,Comedy",8.1,948394
15,Iron Man 2,170000000,312433331,621156389,933589720,763589720,en,28.515,2010-05-07,6.8,12368,2010,124.0,"Action,Adventure,Sci-Fi",7.0,657690
16,Captain America: The Winter Soldier,170000000,259746958,714401889,974148847,804148847,en,18.073,2014-04-04,7.7,11034,2014,136.0,"Action,Adventure,Sci-Fi",7.8,666252
17,Dawn of the Planet of the Apes,170000000,208545589,710644566,919190155,749190155,en,27.641,2014-07-11,7.3,7080,2014,130.0,"Action,Adventure,Drama",7.6,390199
19,Snow White and the Huntsman,170000000,155136755,401021746,556158501,386158501,en,21.233,2012-06-01,5.9,5258,2012,127.0,"Action,Adventure,Drama",6.1,258938
23,Tomorrowland,170000000,93436322,206627518,300063840,130063840,en,20.136,2015-05-22,6.2,4610,2015,130.0,"Action,Adventure,Family",6.4,161343
26,Alice Through the Looking Glass,170000000,77042381,276928112,353970493,183970493,en,16.642,2016-05-27,6.5,3803,2016,113.0,"Adventure,Family,Fantasy",6.2,79951
27,Shrek Forever After,165000000,238736787,756244673,994981460,829981460,en,15.041,2010-05-16,6.1,3843,2010,93.0,"Adventure,Animation,Comedy",6.3,167532
28,Doctor Strange,165000000,232641920,676404566,909046486,744046486,en,33.035,2016-11-04,7.3,12582,2016,115.0,"Action,Adventure,Fantasy",7.5,514510
29,Big Hero 6,165000000,222527828,652127828,874655656,709655656,en,36.92,2014-11-07,7.8,10176,2014,102.0,"Action,Adventure,Animation",7.8,371204
30,How to Train Your Dragon,165000000,217581232,494870992,712452224,547452224,en,28.734,2010-03-26,7.7,7610,2010,98.0,"Action,Adventure,Animation",8.1,611299
31,Wreck-It Ralph,165000000,189412677,496511521,685924198,520924198,en,22.967,2012-11-02,7.3,7780,2012,101.0,"Adventure,Animation,Comedy",7.7,344496
32,Interstellar,165000000,188017894,666379375,854397269,689397269,en,28.44,2014-11-05,8.2,18597,2014,169.0,"Adventure,Drama,Sci-Fi",8.6,1299334
33,Independence Day: Resurgence,165000000,103144286,384169424,487313710,322313710,en,15.732,2016-06-24,5.1,3911,2016,120.0,"Action,Adventure,Sci-Fi",5.2,155344
35,Beauty and the Beast,160000000,504014165,1259199706,1763213871,1603213871,en,26.701,2012-01-13,7.7,5730,2014,112.0,"Drama,Fantasy,Romance",6.4,18100
36,Aquaman,160000000,335061807,1146894640,1481956447,1321956447,en,38.102,2018-12-21,6.8,6155,2018,143.0,"Action,Adventure,Fantasy",7.1,263328
38,Inception,160000000,292576195,835524642,1128100837,968100837,en,27.92,2010-07-16,8.3,22186,2010,148.0,"Action,Adventure,Sci-Fi",8.8,1841066
39,The Hunger Games: Mockingjay - Part 2,160000000,281723902,648986787,930710689,770710689,en,19.487,2015-11-18,6.8,7609,2015,137.0,"Action,Adventure,Sci-Fi",6.6,252384
41,Godzilla,160000000,200676069,529076069,729752138,569752138,en,24.982,2014-05-16,6.1,5053,2014,123.0,"Action,Adventure,Sci-Fi",6.4,350687
42,X-Men: First Class,160000000,146408305,355408305,501816610,341816610,en,1.447,2011-06-03,7.2,8211,2011,131.0,"Action,Adventure,Sci-Fi",7.7,608930
44,The Sorcerer's Apprentice,160000000,63150991,217986320,281137311,121137311,en,14.463,2010-07-13,5.9,2879,2010,109.0,"Action,Adventure,Family",6.1,143862
46,Warcraft,160000000,47225655,425522281,472747936,312747936,en,21.464,2016-06-10,6.3,4071,2016,123.0,"Action,Adventure,Fantasy",6.9,225557
47,Deepwater Horizon,156000000,61433527,122603824,184037351,28037351,en,13.685,2016-09-30,6.7,2606,2016,107.0,"Action,Drama,History",7.1,133303
48,The Chronicles of Narnia: The Voyage of the Dawn Treader,155000000,104386950,418186950,522573900,367573900,en,17.382,2010-12-10,6.3,3196,2010,113.0,"Adventure,Family,Fantasy",6.3,129663
50,Pacific Rim: Uprising,155000000,59874525,290930148,350804673,195804673,en,30.019,2018-03-23,5.9,2213,2018,111.0,"Action,Adventure,Sci-Fi",5.6,89462
52,War for the Planet of the Apes,152000000,146880162,489592267,636472429,484472429,en,23.445,2017-07-14,7.0,5235,2017,140.0,"Action,Adventure,Drama",7.5,201943
55,Wonder Woman,150000000,412563408,821133378,1233696786,1083696786,en,2.841,2013-09-29,5.9,34,2017,141.0,"Action,Adventure,Fantasy",7.5,487527
56,Frozen,150000000,400738009,1272469910,1673207919,1523207919,en,9.678,2010-02-05,5.8,987,2010,93.0,"Adventure,Drama,Sport",6.2,62311
57,Zootopia,150000000,341268248,1019429616,1360697864,1210697864,en,27.549,2016-03-04,7.7,9977,2016,108.0,"Adventure,Animation,Comedy",8.0,383446
62,Moana,150000000,248757044,637517365,886274409,736274409,en,1.96,2015-11-13,6.5,16,2016,107.0,"Adventure,Animation,Comedy",7.6,224253
66,Thor: The Dark World,150000000,206362140,644602516,850964656,700964656,en,31.014,2013-11-08,6.7,10171,2013,112.0,"Action,Adventure,Fantasy",6.9,540996
69,Dunkirk,150000000,190068280,499837368,689905648,539905648,en,24.358,2017-07-19,7.4,9156,2017,106.0,"Action,Drama,History",7.9,466580
70,Thor,150000000,181030624,449326618,630357242,480357242,en,38.068,2011-05-06,6.7,12764,2011,115.0,"Action,Adventure,Fantasy",7.0,683264
74,Kung Fu Panda 2,150000000,165249063,664837547,830086610,680086610,en,17.363,2011-05-25,6.7,3628,2011,90.0,"Action,Adventure,Animation",7.2,228465
75,Mad Max: Fury Road,150000000,153636354,370098020,523734374,373734374,en,28.099,2015-05-15,7.4,14454,2015,120.0,"Action,Adventure,Sci-Fi",8.1,780910
78,Ready Player One,150000000,137690172,579290136,716980308,566980308,en,30.029,2018-03-29,7.6,7021,2018,140.0,"Action,Adventure,Sci-Fi",7.5,301660
83,The Last Airbender,150000000,131772187,319713881,451486068,301486068,en,16.595,2010-07-01,4.6,2143,2010,103.0,"Action,Adventure,Family",4.1,137734
87,Wrath of the Titans,150000000,83670083,305270083,388940166,238940166,en,14.991,2012-03-29,5.6,2442,2012,99.0,"Action,Adventure,Fantasy",5.7,172330
89,Dark Shadows,150000000,79727149,238202668,317929817,167929817,en,15.75,2012-05-11,5.9,4197,2012,113.0,"Comedy,Fantasy,Horror",6.2,229818
90,White House Down,150000000,73103784,205440387,278544171,128544171,en,13.026,2013-06-28,6.4,2817,2013,131.0,"Action,Drama,Thriller",6.4,191791
91,The Wolfman,150000000,62189884,142634358,204824242,54824242,en,14.03,2010-02-12,5.7,1009,2010,103.0,"Drama,Fantasy,Horror",5.8,97873
92,The Great Wall,150000000,45157105,334486852,379643957,229643957,en,19.144,2017-02-17,5.8,2775,2016,103.0,"Action,Adventure,Fantasy",6.0,111602
93,Pan,150000000,35088320,151525973,186614293,36614293,en,13.054,2015-10-09,5.9,1701,2015,111.0,"Adventure,Comedy,Family",5.8,55867
94,Mars Needs Moms,150000000,21392758,39549758,60942516,-89057484,en,8.852,2011-03-11,5.7,299,2011,88.0,"Adventure,Animation,Family",5.4,19823
97,Madagascar 3: Europe's Most Wanted,145000000,216391482,746921271,963312753,818312753,en,18.705,2012-06-08,6.5,3380,2012,93.0,"Adventure,Animation,Comedy",6.8,146858
99,How to Train Your Dragon 2,145000000,177002924,614586270,791589194,646589194,en,27.106,2014-06-13,7.7,5589,2014,102.0,"Action,Adventure,Animation",7.8,278205
100,Tarzan,145000000,171091819,448191819,619283638,474283638,en,7.727,2013-12-20,5.5,348,2013,94.0,"Adventure,Animation,Drama",4.8,11728
1,Mr. Peabody & Sherman,145000000,111506430,269806430,381312860,236312860,en,12.813,2014-03-07,6.6,1357,2014,92.0,"Adventure,Animation,Comedy",6.8,57277
2,Rise of the Guardians,145000000,103412758,306900902,410313660,265313660,en,14.934,2012-11-21,7.3,3697,2012,97.0,"Action,Adventure,Animation",7.3,145281
4,Ghostbusters,144000000,128350574,229008658,357359232,213359232,en,16.079,2016-07-15,5.4,3780,2016,116.0,"Action,Comedy,Fantasy",5.2,186788
10,Captain America: The First Avenger,140000000,176654505,370569776,547224281,407224281,en,25.808,2011-07-22,6.9,12810,2011,124.0,"Action,Adventure,Sci-Fi",6.9,668137
11,Kung Fu Panda 3,140000000,143528619,517599142,661127761,521127761,en,16.248,2016-01-29,6.7,2944,2016,95.0,"Action,Adventure,Animation",7.1,116166
13,G.I. Joe: Retaliation,140000000,122523060,375740705,498263765,358263765,en,15.065,2013-03-29,5.5,3883,2013,110.0,"Action,Adventure,Sci-Fi",5.8,165536
16,Exodus: Gods and Kings,140000000,65014513,268314513,333329026,193329026,en,26.789,2014-12-12,5.7,2909,2014,150.0,"Action,Adventure,Drama",6.0,150858
17,The BFG,140000000,55483770,199646680,255130450,115130450,en,20.08,2016-07-01,6.2,1916,2016,117.0,"Adventure,Family,Fantasy",6.4,69340
18,Gods of Egypt,140000000,31153464,138836756,169990220,29990220,en,18.517,2016-02-26,5.4,2353,2016,127.0,"Action,Adventure,Fantasy",5.4,95111
26,The Croods,135000000,187168425,573068425,760236850,625236850,en,16.29,2013-03-22,6.8,3873,2013,98.0,"Action,Adventure,Animation",7.2,176699
27,The Revenant,135000000,183637894,532938302,716576196,581576196,en,19.41,2015-12-25,7.4,11064,2015,156.0,"Action,Adventure,Biography",8.0,621193
29,Rango,135000000,123477607,245724600,369202207,234202207,en,14.462,2011-03-03,6.6,3412,2011,107.0,"Adventure,Animation,Comedy",7.2,215761
31,Turbo,135000000,83028130,286896578,369924708,234924708,en,14.876,2013-07-19,6.1,1758,2013,96.0,"Adventure,Animation,Comedy",6.4,74639
32,Teenage Mutant Ninja Turtles: Out of the Shadows,135000000,82051601,245328374,327379975,192379975,en,15.096,2016-06-03,5.9,1860,2016,112.0,"Action,Adventure,Comedy",6.0,77234
33,Happy Feet Two,135000000,64006466,157956466,221962932,86962932,en,8.131,2011-11-17,5.9,754,2011,100.0,"Adventure,Animation,Comedy",5.9,38396
35,The Nutcracker and the Four Realms,132900000,54858851,170293899,225152750,92252750,en,26.235,2018-11-02,6.0,909,2018,99.0,"Adventure,Family,Fantasy",5.5,18734
36,War of the Worlds,132000000,234280354,606836535,841116889,709116889,en,0.6,2013-10-29,7.1,5,2013,50.0,Sci-Fi,5.8,11
37,Penguins of Madagascar,132000000,83350911,366942531,450293442,318293442,en,20.899,2014-11-26,6.4,2273,2014,92.0,"Adventure,Animation,Comedy",6.7,72551
38,The Hunger Games: Catching Fire,130000000,424668047,864868047,1289536094,1159536094,en,20.187,2013-11-22,7.4,11170,2013,146.0,"Action,Adventure,Sci-Fi",7.5,575455
41,Ant-Man and the Wasp,130000000,216648740,623144660,839793400,709793400,en,44.729,2018-07-06,7.0,6290,2018,118.0,"Action,Adventure,Comedy",7.1,244024
43,Ant-Man,130000000,180202163,518858449,699060612,569060612,en,32.715,2015-07-17,7.1,11949,2015,117.0,"Action,Adventure,Comedy",7.3,501213
44,Home,130000000,177397510,385997896,563395406,433395406,ru,1.823,2011-11-11,5.4,11,2011,76.0,Drama,6.0,96
45,Mary Poppins Returns,130000000,171958438,341528518,513486956,383486956,en,30.419,2018-12-19,6.6,1457,2018,130.0,"Comedy,Family,Fantasy",6.9,52103
46,Puss in Boots,130000000,149260504,554987477,704247981,574247981,en,9.078,2011-10-28,6.3,1422,2011,90.0,"Action,Adventure,Animation",6.6,133355
47,Megamind,130000000,148415853,321887208,470303061,340303061,en,22.855,2010-11-04,6.8,3635,2010,95.0,"Action,Animation,Comedy",7.3,207488
49,Rio 2,130000000,131538435,492846291,624384726,494384726,en,18.11,2014-04-11,6.3,1803,2014,101.0,"Adventure,Animation,Comedy",6.3,72209
50,Salt,130000000,118311368,290650494,408961862,278961862,en,13.025,2010-07-23,6.3,3240,2010,100.0,"Action,Mystery,Thriller",6.4,277204
51,Noah,130000000,101200044,352831065,454031109,324031109,en,0.6,2013-09-09,7.6,11,2012,,Animation,5.6,223
52,The Adventures of Tintin,130000000,77591831,373993951,451585782,321585782,en,11.981,2011-12-20,6.8,3251,2011,107.0,"Action,Adventure,Animation",7.3,202430
53,After Earth,130000000,60522097,251499665,312021762,182021762,en,14.415,2013-05-31,5.1,4154,2013,100.0,"Action,Adventure,Drama",4.8,181687
55,R.I.P.D.,130000000,33618855,79076678,112695533,-17304467,en,21.377,2013-07-19,5.6,2047,2013,96.0,"Action,Adventure,Comedy",5.6,109078
59,Logan,127000000,226277068,615461394,841738462,714738462,en,0.964,2010-09-10,6.1,4,2010,94.0,"Comedy,Drama,Family",6.2,252
60,Night at the Museum: Secret of the Tomb,127000000,113746621,353756621,467503242,340503242,en,20.064,2014-12-19,6.1,3536,2014,98.0,"Adventure,Comedy,Family",6.2,93103
62,The Hunger Games: Mockingjay - Part 1,125000000,337135885,766575131,1103711016,978711016,en,33.837,2014-11-21,6.8,10087,2014,123.0,"Action,Adventure,Sci-Fi",6.6,379050
67,Fast Five,125000000,210031325,630163454,840194779,715194779,en,2.097,2011-04-28,7.2,4294,2011,130.0,"Action,Crime,Thriller",7.3,329892
68,Teenage Mutant Ninja Turtles,125000000,191204754,485004754,676209508,551209508,en,25.619,2014-08-08,5.8,4259,2014,101.0,"Action,Adventure,Comedy",5.8,192220
69,Sherlock Holmes: A Game of Shadows,125000000,186848418,535663443,722511861,597511861,en,18.301,2011-12-16,7.1,6380,2011,129.0,"Action,Adventure,Crime",7.5,394189
71,The Boss Baby,125000000,175003033,510878762,685881795,560881795,en,7.445,2017-03-31,6.4,4314,2017,97.0,"Adventure,Animation,Comedy",6.3,93730
72,Clash of the Titans,125000000,163214888,493214888,656429776,531429776,en,15.574,2010-04-02,5.7,3714,2010,106.0,"Action,Adventure,Fantasy",5.8,256176
73,Trolls,125000000,153707064,344150134,497857198,372857198,en,16.286,2016-11-04,6.6,1880,2016,92.0,"Adventure,Animation,Comedy",6.5,63295
75,Prometheus,125000000,126477084,402448265,528925349,403925349,en,24.98,2012-06-08,6.4,7384,2012,124.0,"Adventure,Mystery,Sci-Fi",7.0,538720
76,The Bourne Legacy,125000000,113203870,280355920,393559790,268559790,en,18.05,2012-08-10,6.1,3630,2012,135.0,"Action,Adventure,Thriller",6.7,268678
78,Skyscraper,125000000,68420120,304115534,372535654,247535654,en,26.229,2018-07-13,6.1,2177,2018,102.0,"Action,Adventure,Thriller",5.8,81193
79,Total Recall,125000000,58877969,211856088,270734057,145734057,en,17.243,2012-08-03,5.9,3486,2012,118.0,"Action,Adventure,Mystery",6.3,228460
81,Monster Trucks,125000000,33370166,61642798,95012964,-29987036,en,8.827,2017-01-13,5.9,414,2016,104.0,"Action,Adventure,Comedy",5.7,13525
86,Jason Bourne,120000000,162192920,416168316,578361236,458361236,en,14.568,2016-07-29,6.1,3611,2016,123.0,"Action,Thriller",6.6,190596
88,Life of Pi,120000000,124987022,620912003,745899025,625899025,en,15.0,2012-11-21,7.3,8723,2012,127.0,"Adventure,Drama,Fantasy",7.9,535836
90,Rampage,120000000,101028233,428056280,529084513,409084513,en,24.238,2018-04-13,6.2,3176,2018,107.0,"Action,Adventure,Sci-Fi",6.1,115891
92,Elysium,120000000,93050117,286192091,379242208,259242208,en,17.663,2013-08-09,6.4,5406,2013,109.0,"Action,Drama,Sci-Fi",6.6,395572
93,Oblivion,120000000,89107235,287916633,377023868,257023868,en,18.534,2013-04-18,6.5,6850,2013,124.0,"Action,Adventure,Sci-Fi",7.0,453966
94,Power Rangers,120000000,85364450,142531552,227896002,107896002,en,15.865,2017-03-24,6.2,2667,2017,124.0,"Action,Adventure,Sci-Fi",6.0,92013
96,RoboCop,120000000,58607007,242981799,301588806,181588806,en,17.851,2014-02-12,5.8,3390,2014,117.0,"Action,Crime,Sci-Fi",6.2,205798
98,Fantastic Four,120000000,56117548,167849187,223966735,103966735,en,16.36,2015-08-07,4.4,3837,2015,100.0,"Action,Adventure,Drama",4.3,140148
2,Knight and Day,117000000,76423035,258751370,335174405,218174405,en,17.713,2010-06-23,6.0,2494,2010,109.0,"Action,Adventure,Comedy",6.3,169840
3,Venom,116000000,213511408,853628605,1067140013,951140013,en,2.758,2011-07-15,4.3,6,2018,112.0,"Action,Sci-Fi,Thriller",6.7,275406
8,The Wolverine,115000000,132556852,416456852,549013704,434013704,en,4.323,2013-07-25,6.3,6176,2013,126.0,"Action,Adventure,Sci-Fi",6.7,401286
13,Gulliver's Travels,112000000,42779261,232017848,274797109,162797109,en,10.768,2010-12-25,5.1,1282,2010,85.0,"Adventure,Comedy,Family",4.9,61178
14,Ferdinand,111000000,84410380,289847930,374258310,263258310,en,19.479,2017-12-15,7.1,1425,2017,108.0,"Adventure,Animation,Comedy",6.7,40229
15,Deadpool 2,110000000,324591735,786680557,1111272292,1001272292,en,38.894,2018-05-10,7.5,8773,2018,119.0,"Action,Adventure,Comedy",7.8,391735
16,Gravity,110000000,274092705,693698673,967791378,857791378,en,27.836,2013-10-04,7.2,9586,2013,91.0,"Drama,Sci-Fi,Thriller",7.7,710018
19,San Andreas,110000000,155190832,456258539,611449371,501449371,en,27.414,2015-05-29,6.1,5125,2015,114.0,"Action,Adventure,Drama",6.1,192750
20,The Smurfs,110000000,142614158,563749323,706363481,596363481,en,16.533,2011-07-29,5.6,2112,2011,103.0,"Adventure,Animation,Comedy",5.5,77577
26,300: Rise of an Empire,110000000,106580051,330780051,437360102,327360102,en,23.68,2014-03-07,6.0,3870,2014,102.0,"Action,Fantasy,War",6.2,262978
28,Passengers,110000000,100014699,302239672,402254371,292254371,en,14.074,2016-12-21,6.8,7869,2016,116.0,"Drama,Romance,Sci-Fi",7.0,311083
29,The Green Hornet,110000000,98780042,229155503,327935545,217935545,en,14.501,2011-01-13,5.5,1897,2011,119.0,"Action,Comedy,Crime",5.8,148622
31,Real Steel,110000000,85463309,263880341,349343650,239343650,en,14.811,2011-10-06,6.8,4566,2011,127.0,"Action,Drama,Family",7.1,283534
32,The A-Team,110000000,77222099,177241171,254463270,144463270,en,17.097,2010-06-11,6.3,2703,2010,117.0,"Action,Adventure,Thriller",6.8,235256
33,The Smurfs 2,110000000,71017784,348547523,419565307,309565307,en,12.941,2013-07-31,5.7,1200,2013,105.0,"Adventure,Animation,Comedy",5.4,34229
36,Ender's Game,110000000,61737191,127983283,189720474,79720474,en,15.533,2013-11-01,6.6,3558,2013,114.0,"Action,Adventure,Fantasy",6.6,211722
40,Ghost in the Shell,110000000,40563557,167910690,208474247,98474247,en,21.308,2017-03-31,6.0,5128,2017,107.0,"Action,Drama,Sci-Fi",6.4,176499
46,The Martian,108000000,228433663,655271443,883705106,775705106,en,22.856,2015-10-02,7.7,12172,2015,144.0,"Adventure,Drama,Sci-Fi",8.0,680116
47,Allied,106000000,40098064,119266661,159364725,53364725,en,19.611,2016-11-23,6.7,2765,2016,124.0,"Action,Drama,Romance",7.1,125741
52,Ice Age: Collision Course,105000000,64063008,402156682,466219690,361219690,en,18.233,2016-07-22,5.9,2430,2016,94.0,"Adventure,Animation,Comedy",5.7,48932
54,Kingsman: The Golden Circle,104000000,100234838,408803696,509038534,405038534,en,24.337,2017-09-22,7.0,5531,2017,141.0,"Action,Adventure,Comedy",6.8,230797
58,A Wrinkle in Time,103000000,100478608,133401882,233880490,130880490,en,12.529,2018-03-09,5.0,1073,2018,109.0,"Adventure,Family,Fantasy",4.2,34888
62,Bumblebee,102000000,127195589,465195589,592391178,490391178,en,43.078,2018-12-21,6.5,2425,2018,114.0,"Action,Adventure,Sci-Fi",6.9,94155
63,Cloud Atlas,102000000,27108272,130673154,157781426,55781426,en,14.681,2012-10-26,6.8,4505,2012,172.0,"Action,Drama,Mystery",7.4,326473
69,Django Unchained,100000000,162805434,449948323,612753757,512753757,en,21.26,2012-12-25,8.0,15725,2012,165.0,"Drama,Western",8.4,1211405
70,Little Fockers,100000000,148438600,310650574,459089174,359089174,en,12.153,2010-12-21,5.6,1883,2010,98.0,"Comedy,Romance",5.5,99222
74,The Other Guys,100000000,119219978,170936470,290156448,190156448,en,13.508,2010-08-06,6.2,2187,2010,107.0,"Action,Comedy,Crime",6.7,221664
76,The Wolf of Wall Street,100000000,116900694,389870414,506771108,406771108,en,29.518,2013-12-25,7.9,12411,2013,180.0,"Biography,Crime,Drama",8.2,1035358
77,Epic,100000000,107518682,262794441,370313123,270313123,en,13.995,2013-05-24,6.4,1670,2013,102.0,"Adventure,Animation,Family",6.7,95318
81,The Expendables 2,100000000,85028192,311979256,397007448,297007448,en,17.216,2012-08-17,6.2,4219,2012,103.0,"Action,Adventure,Thriller",6.6,277584
84,Hercules,100000000,72688614,243388614,316077228,216077228,en,23.922,2014-07-25,5.6,2606,2014,98.0,"Action,Adventure,Fantasy",6.0,137287
85,The Tourist,100000000,67631157,278731369,346362526,246362526,en,10.307,2010-12-10,6.1,3133,2010,103.0,"Action,Adventure,Thriller",6.0,206714
90,Legend of the Guardians: The Owls of Ga'Hoole,100000000,55675313,139716717,195392030,95392030,en,10.754,2010-09-24,6.6,1223,2010,97.0,"Action,Adventure,Animation",7.0,73790
96,The Expendables 3,100000000,39322544,209461378,248783922,148783922,en,18.797,2014-08-15,6.1,2876,2014,126.0,"Action,Adventure,Thriller",6.1,156432
98,Green Zone,100000000,35497337,97523020,133020357,33020357,en,11.519,2010-03-11,6.4,1176,2010,115.0,"Action,Drama,Thriller",6.8,122132
99,Geostorm,100000000,33700160,220796009,254496169,154496169,en,13.653,2017-10-20,5.8,2246,2017,109.0,"Action,Sci-Fi,Thriller",5.3,78287
100,Point Break,100000000,28782481,126704591,155487072,55487072,en,9.435,2015-12-25,5.6,1260,2015,114.0,"Action,Crime,Sport",5.3,53802
1,In the Heart of the Sea,100000000,25020758,89693309,114714067,14714067,en,14.33,2015-12-11,6.6,2137,2015,122.0,"Action,Adventure,Biography",6.9,108628
2,Transcendence,100000000,23022309,103039258,126061567,26061567,en,0.6,2012-06-09,5.5,2,2012,98.0,Drama,6.1,22
4,Mortal Engines,100000000,15951040,85287417,101238457,1238457,en,40.095,2018-12-14,6.0,1751,2018,128.0,"Action,Adventure,Fantasy",6.1,70193
7,The Peanuts Movie,99000000,130178411,250091610,380270021,281270021,en,11.344,2015-11-01,6.6,894,2015,88.0,"Adventure,Animation,Comedy",7.1,39149
12,Alien: Covenant,97000000,74262031,238521247,312783278,215783278,en,24.651,2017-05-19,5.9,4971,2017,122.0,"Horror,Sci-Fi,Thriller",6.4,226920
13,Cinderella,95000000,201151353,534551353,735702706,640702706,ru,0.955,2012-06-06,4.6,8,2015,105.0,"Drama,Family,Fantasy",6.9,142792
14,Ice Age: Continental Drift,95000000,161321843,879765137,1041086980,946086980,en,17.537,2012-07-13,6.3,4598,2012,88.0,"Adventure,Animation,Comedy",6.6,175601
16,Sex and the City 2,95000000,95347692,294680778,390028470,295028470,en,9.986,2010-05-27,5.9,809,2010,146.0,"Comedy,Drama,Romance",4.4,69199
17,Percy Jackson & the Olympians: The Lightning Thief,95000000,88768303,223050874,311819177,216819177,en,26.691,2010-02-11,6.1,4229,2010,118.0,"Adventure,Family,Fantasy",5.9,165108
18,The Campaign,95000000,86907746,104907746,191815492,96815492,en,10.266,2012-08-10,5.7,982,2012,85.0,Comedy,6.1,118678
19,Unstoppable,95000000,81562942,165720921,247283863,152283863,en,14.01,2010-11-12,6.4,1913,2010,98.0,"Action,Thriller",6.8,173019
23,Ben-Hur,95000000,26410477,91669648,118080125,23080125,en,10.11,2016-08-19,5.6,1068,2016,123.0,"Action,Adventure,Drama",5.7,37975
24,Seventh Son,95000000,17725785,108874967,126600752,31600752,en,22.856,2015-02-06,5.3,1549,2014,102.0,"Action,Adventure,Fantasy",5.5,66565
29,Kingsman: The Secret Service,94000000,128261724,404561724,532823448,438823448,en,26.103,2015-02-13,7.6,10287,2014,129.0,"Action,Adventure,Comedy",7.7,544510
31,Rise of the Planet of the Apes,93000000,176760185,470986200,647746385,554746385,en,22.995,2011-08-04,7.2,7259,2011,105.0,"Action,Drama,Sci-Fi",7.6,473020
34,A Good Day to Die Hard,92000000,67349198,304249198,371598396,279598396,en,15.858,2013-02-14,5.2,4437,2013,98.0,"Action,Thriller",5.3,188383
37,The Secret Life of Walter Mitty,91000000,58236838,187861183,246098021,155098021,en,10.743,2013-12-25,7.1,4859,2013,114.0,"Adventure,Comedy,Drama",7.3,275300
38,Jumanji: Welcome to the Jungle,90000000,404508916,964496193,1369005109,1279005109,en,20.395,2017-12-20,6.7,7213,2017,119.0,"Action,Adventure,Comedy",7.0,242735
42,Sherlock Holmes,90000000,209028679,498438212,707466891,617466891,en,5.39,2010-01-26,5.6,53,2011,77.0,Adventure,5.4,48
46,Rio,90000000,143619809,487519809,631139618,541139618,en,14.695,2011-04-15,6.6,3730,2011,96.0,"Adventure,Animation,Comedy",6.9,191621
51,The Girl with the Dragon Tattoo,90000000,102515793,239373970,341889763,251889763,en,17.823,2011-12-14,7.3,3971,2011,158.0,"Crime,Drama,Mystery",7.8,387580
55,The Magnificent Seven,90000000,93432655,162525156,255957811,165957811,en,18.487,2016-09-23,6.2,3647,2016,132.0,"Action,Adventure,Western",6.9,168514
56,Alvin and the Chipmunks: The Road Chip,90000000,85886987,249517956,335404943,245404943,en,14.973,2015-12-18,5.8,852,2015,92.0,"Adventure,Animation,Comedy",5.1,14507
59,Pixels,90000000,78765986,244041804,322807790,232807790,en,2.172,2010-04-01,7.1,35,2010,100.0,"Action,Comedy",4.6,54
64,Percy Jackson: Sea of Monsters,90000000,68559554,200859554,269419108,179419108,en,15.762,2013-08-07,5.9,3109,2013,106.0,"Adventure,Family,Fantasy",5.8,102313
66,Now You See Me 2,90000000,65075540,328325007,393400547,303400547,en,25.805,2016-06-10,6.8,6744,2016,129.0,"Action,Adventure,Comedy",6.5,216219
68,The Saint,90000000,61363304,169400000,230763304,140763304,en,6.958,2017-07-11,5.1,133,2016,96.0,Drama,6.4,516
70,Tomb Raider,90000000,58250803,273477501,331728304,241728304,en,24.968,2018-03-16,6.3,4310,2018,119.0,"Action,Adventure,Fantasy",6.3,163560
76,Conan the Barbarian,90000000,21295021,63356133,84651154,-5348846,en,17.046,2011-08-19,5.2,1024,2011,113.0,"Action,Adventure,Fantasy",5.2,90834
77,The Three Musketeers,90000000,20377913,139877913,160255826,70255826,en,11.932,2011-10-20,5.7,1596,2011,110.0,"Action,Adventure,Romance",5.8,98408
78,The Promise,90000000,8224288,10551417,18775705,-71224295,en,0.6,2013-10-16,9.0,1,2017,,Comedy,8.8,53
79,The Nutcracker in 3D,90000000,195459,20466016,20661475,-69338525,en,7.566,2010-11-24,5.5,97,2010,110.0,"Action,Family,Fantasy",4.3,3119
80,Bright,90000000,0,0,0,-90000000,en,15.677,2017-12-22,6.2,3181,2017,117.0,"Action,Crime,Fantasy",6.4,147834
84,The Predator,88000000,51024708,159487563,210512271,122512271,en,29.473,2018-09-14,5.2,2018,2018,107.0,"Action,Adventure,Sci-Fi",5.4,94888
95,Divergent,85000000,150947895,276014965,426962860,341962860,en,16.982,2014-03-21,6.9,8279,2014,139.0,"Action,Adventure,Mystery",6.7,399703
96,Hotel Transylvania,85000000,148313048,378505812,526818860,441818860,en,15.318,2012-09-28,6.9,5013,2012,91.0,"Animation,Comedy,Family",7.1,204571
99,Safe House,85000000,126181630,208542162,334723792,249723792,en,13.116,2012-02-10,6.4,1997,2012,115.0,"Action,Adventure,Crime",6.8,192655
5,Tower Heist,85000000,78046570,150422946,228469516,143469516,en,12.213,2011-11-04,6.0,1592,2011,104.0,"Action,Comedy,Crime",6.2,125102
7,Mirror Mirror,85000000,64935167,173613482,238548649,153548649,en,13.221,2012-03-30,5.8,2099,2012,106.0,"Adventure,Comedy,Drama",5.6,79510
14,Arthur Christmas,85000000,46462469,149717124,196179593,111179593,en,12.981,2011-11-23,6.7,692,2011,97.0,"Adventure,Animation,Comedy",7.1,45439
15,xXx: Return of Xander Cage,85000000,44898413,345033359,389931772,304931772,en,21.749,2017-01-20,5.6,2452,2017,107.0,"Action,Adventure,Thriller",5.2,77976
17,Cats & Dogs: The Revenge of Kitty Galore,85000000,43585753,113026383,156612136,71612136,en,10.544,2010-07-30,4.9,273,2010,82.0,"Action,Comedy,Family",4.3,12642
24,Father's Day,85000000,28681080,35681080,64362160,-20637840,en,3.186,2011-06-19,5.9,37,2011,99.0,"Action,Comedy,Horror",6.0,2482
25,The Greatest Showman,84000000,174340174,386665550,561005724,477005724,en,22.009,2017-12-20,8.0,5197,2017,105.0,"Biography,Drama,Musical",7.6,199663
28,RED 2,84000000,53262560,141507355,194769915,110769915,en,14.994,2013-07-19,6.5,2368,2013,116.0,"Action,Comedy,Crime",6.6,148846
34,The Expendables,82000000,103068524,268268174,371336698,289336698,en,21.517,2010-08-03,6.1,4647,2010,103.0,"Action,Adventure,Thriller",6.5,307897
38,The Hunger Games,80000000,408010692,677923379,1085934071,1005934071,en,14.212,2012-03-23,7.1,14587,2012,142.0,"Action,Adventure,Sci-Fi",7.2,795227
39,The Hangover Part II,80000000,254464305,586464305,840928610,760928610,en,32.266,2011-05-25,6.4,6231,2011,102.0,"Comedy,Mystery",6.5,432800
41,The Lego Batman Movie,80000000,175750384,310660018,486410402,406410402,en,19.352,2017-02-10,7.2,2882,2017,104.0,"Action,Animation,Comedy",7.3,116433
42,Hotel Transylvania 2,80000000,169700110,469500298,639200408,559200408,en,16.553,2015-09-25,6.7,3184,2015,89.0,"Animation,Comedy,Family",6.7,92905
48,Grown Ups 2,80000000,133668525,247023808,380692333,300692333,en,11.289,2013-07-12,5.9,2090,2013,101.0,Comedy,5.4,128500
49,Alvin and the Chipmunks: Chipwrecked,80000000,133107389,349088523,482195912,402195912,en,12.672,2011-12-16,5.5,1055,2011,87.0,"Adventure,Animation,Comedy",4.4,28158
52,Shutter Island,80000000,128012934,299461782,427474716,347474716,en,18.06,2010-02-18,8.1,12625,2010,138.0,"Mystery,Thriller",8.1,1005960
62,Yogi Bear,80000000,100246011,204774690,305020701,225020701,en,9.096,2010-12-17,5.3,387,2010,80.0,"Adventure,Animation,Comedy",4.6,18934
64,The Book of Eli,80000000,94835059,158750817,253585876,173585876,en,18.985,2010-01-11,6.7,3495,2010,118.0,"Action,Adventure,Drama",6.9,271307
68,Fury,80000000,85817906,210315681,296133587,216133587,en,29.117,2014-10-17,7.4,6653,2014,134.0,"Action,Drama,War",7.6,381993
69,Smallfoot,80000000,83240103,213691277,296931380,216931380,en,26.231,2018-09-28,6.6,600,2018,96.0,"Adventure,Animation,Comedy",6.7,23295
71,Zookeeper,80000000,80360866,170805525,251166391,171166391,en,10.764,2011-07-08,5.3,886,2011,102.0,"Comedy,Family,Romance",5.2,52396
73,Conspiracy Theory,80000000,76118990,142783718,218902708,138902708,en,10.151,1997-08-08,6.5,707,2016,79.0,"Horror,Thriller",5.8,688
89,Evolution,80000000,38311134,98341932,136653066,56653066,fr,4.208,2015-09-14,6.3,73,2015,81.0,"Drama,Mystery,Sci-Fi",6.0,5266
95,Daylight,80000000,32908290,158908290,191816580,111816580,en,1.4,2011-07-17,4.2,3,2010,75.0,"Crime,Horror,Thriller",5.1,201
96,The Last Witch Hunter,80000000,27367660,130818912,158186572,78186572,en,16.685,2015-10-23,5.8,2193,2015,106.0,"Action,Adventure,Fantasy",6.0,86118
97,Pompeii,80000000,23169033,108469033,131638066,51638066,en,25.215,2014-02-21,5.4,2078,2014,105.0,"Action,Adventure,Drama",5.5,100467
10,Journey 2: The Mysterious Island,79000000,103860290,318146162,422006452,343006452,en,14.454,2012-02-10,5.9,2152,2012,94.0,"Action,Adventure,Comedy",5.8,83507
11,Jack and Jill,79000000,74158157,150519217,224677374,145677374,en,11.277,2011-11-11,4.1,1124,2011,91.0,Comedy,3.3,71361
13,Cloudy with a Chance of Meatballs 2,78000000,119793567,274392649,394186216,316186216,en,18.335,2013-09-27,6.4,1679,2013,95.0,"Adventure,Animation,Comedy",6.4,81010
19,The Little Prince,77500000,1311213,102028919,103340132,25840132,en,8.512,2016-08-05,7.6,1493,2019,93.0,Action,8.3,6
21,The Equalizer 2,77000000,102084362,190453132,292537494,215537494,en,22.961,2018-07-20,6.4,2089,2018,121.0,"Action,Crime,Thriller",6.7,97963
22,Despicable Me 2,76000000,368065385,975216835,1343282220,1267282220,en,19.014,2013-07-03,6.9,7319,2013,98.0,"Adventure,Animation,Comedy",7.4,344230
26,The Secret Life of Pets,75000000,368384330,886750534,1255134864,1180134864,en,9.909,2016-07-08,6.1,5374,2016,87.0,"Adventure,Animation,Comedy",6.5,161997
29,Sing,75000000,270329045,634454789,904783834,829783834,en,17.572,2016-12-21,6.9,4303,2016,108.0,"Animation,Comedy,Family",7.1,115951
30,Despicable Me 3,75000000,264624300,1034727750,1299352050,1224352050,en,16.407,2017-06-30,6.3,4106,2017,89.0,"Adventure,Animation,Comedy",6.3,92580
34,Grown Ups,75000000,162001186,272223430,434224616,359224616,en,14.291,2010-06-24,6.1,3171,2010,102.0,Comedy,6.0,210377
41,Now You See Me,75000000,117723989,342769200,460493189,385493189,en,16.646,2013-05-31,7.4,9871,2013,115.0,"Crime,Mystery,Thriller",7.3,553156
43,Christopher Robin,75000000,99215042,197504758,296719800,221719800,en,20.931,2018-08-03,7.4,1280,2018,104.0,"Adventure,Animation,Comedy",7.3,52737
45,Immortals,75000000,83504017,211562435,295066452,220066452,en,14.774,2011-11-11,5.8,1431,2011,110.0,"Action,Drama,Fantasy",6.0,152992
51,Life,75000000,64062587,73521587,137584174,62584174,en,6.425,2015-12-04,6.1,210,2010,75.0,Documentary,7.8,5
54,Killers,75000000,47059963,95572749,142632712,67632712,en,10.221,2010-06-04,5.8,1314,2010,100.0,"Action,Comedy,Romance",5.4,82237
62,Sucker Punch,75000000,36392502,89758389,126150891,51150891,en,14.416,2011-03-25,6.0,2716,2011,110.0,"Action,Adventure,Fantasy",6.1,218371
63,Hostage,75000000,34636443,77636443,112272886,37272886,en,0.687,2013-09-03,3.8,3,2012,91.0,Thriller,5.7,446
64,Inferno,75000000,34343574,219519367,253862941,178862941,en,17.41,2016-10-28,5.9,3877,2010,100.0,Thriller,6.3,50
73,Minions,74000000,336045770,1160336173,1496381943,1422381943,en,9.338,2015-07-10,6.4,7343,2015,91.0,"Adventure,Animation,Comedy",6.4,193917
74,The SpongeBob Movie: Sponge Out of Water,74000000,162994032,311013181,474007213,400007213,en,13.815,2015-02-06,5.7,1165,2015,92.0,"Adventure,Animation,Comedy",6.0,43560
77,The Angry Birds Movie,73000000,107509366,352327887,459837253,386837253,en,17.998,2016-05-20,6.0,1851,2016,97.0,"Action,Animation,Comedy",6.3,69624
9,Olympus Has Fallen,70000000,98927592,172878928,271806520,201806520,en,13.864,2013-03-22,6.2,4086,2013,119.0,"Action,Thriller",6.5,235443
12,War Horse,70000000,79883359,156815529,236698888,166698888,en,10.378,2011-12-25,7.2,1849,2011,146.0,"Drama,History,War",7.2,136447
14,The Monuments Men,70000000,78031620,158702748,236734368,166734368,en,12.861,2014-02-07,5.9,2229,2014,118.0,"Comedy,Drama,History",6.1,117638
15,Storks,70000000,72679278,183353431,256032709,186032709,en,12.101,2016-09-23,6.5,1308,2016,87.0,"Adventure,Animation,Comedy",6.8,50448
18,Wolf,70000000,65011757,131011757,196023514,126023514,en,0.6,2012-03-11,7.0,2,2010,98.0,"Action,Crime,Drama",4.7,87
20,The Lego Ninjago Movie,70000000,59281555,122737201,182018756,112018756,en,14.607,2017-09-22,6.3,424,2017,101.0,"Action,Adventure,Animation",6.0,18926
21,Dracula Untold,70000000,55991880,220241723,276233603,206233603,en,29.043,2014-10-03,6.2,3719,2014,92.0,"Action,Drama,Fantasy",6.3,164829
22,The Guardian,70000000,55011732,94973540,149985272,79985272,en,0.84,2010-10-01,5.3,2,2016,72.0,"Action,Mystery,Sci-Fi",6.7,19
25,The Dilemma,70000000,48475290,70546865,119022155,49022155,en,9.518,2011-01-13,5.3,448,2011,111.0,"Comedy,Drama",5.3,48148
29,Rock of Ages,70000000,38518613,61031932,99550545,29550545,en,11.369,2012-06-15,6.1,686,2012,123.0,"Comedy,Drama,Musical",5.9,69910
34,Bad Company,70000000,30157016,69157016,99314032,29314032,en,1.836,2018-08-14,10.0,1,2010,87.0,Thriller,5.1,10
36,The Finest Hours,70000000,27569558,49252761,76822319,6822319,en,12.673,2016-01-29,6.4,943,2016,117.0,"Action,Drama,History",6.8,55981
37,Escape Plan,70000000,25135965,103735965,128871930,58871930,en,17.88,2013-10-18,6.7,2799,2013,115.0,"Action,Crime,Mystery",6.7,211587
38,Killer Elite,70000000,25124986,65409046,90534032,20534032,en,15.135,2011-09-23,6.2,1093,2011,116.0,"Action,Crime,Thriller",6.5,117711
42,The Legend of Hercules,70000000,18848538,58953319,77801857,7801857,en,13.754,2014-01-10,4.5,805,2014,99.0,"Action,Adventure,Fantasy",4.2,50352
47,Blackhat,70000000,8005980,19665004,27670984,-42329016,en,16.824,2015-01-16,5.3,1165,2015,133.0,"Action,Crime,Thriller",5.4,48427
50,Despicable Me,69000000,251513985,543464573,794978558,725978558,en,23.673,2010-07-09,7.2,10057,2010,95.0,"Animation,Comedy,Family",7.7,464511
51,Dinner for Schmucks,69000000,73026337,86796502,159822839,90822839,en,6.632,2010-07-30,5.6,920,2010,114.0,Comedy,5.9,91546
52,Red Sparrow,69000000,46874505,145951861,192826366,123826366,en,18.117,2018-03-02,6.5,3406,2018,140.0,"Action,Drama,Thriller",6.6,136738
53,The Twilight Saga: Eclipse,68000000,300531751,706102828,1006634579,938634579,en,20.34,2010-06-23,6.0,4909,2010,124.0,"Adventure,Drama,Fantasy",5.0,211733
55,Ted 2,68000000,81476385,217214143,298690528,230690528,en,17.684,2015-06-26,6.1,4227,2015,115.0,Comedy,6.3,165843
57,Hall Pass,68000000,45060734,87173475,132234209,64234209,en,9.984,2011-02-25,5.5,1009,2011,105.0,"Comedy,Romance",5.9,113775
59,Dreamcatcher,68000000,33685268,75685268,109370536,41370536,en,1.4,2015-03-27,5.2,5,2015,104.0,"Crime,Documentary,Drama",7.1,395
62,Downsizing,68000000,24449754,54462971,78912725,10912725,en,10.682,2017-12-22,5.1,1887,2017,135.0,"Drama,Sci-Fi",5.7,74815
65,Abraham Lincoln: Vampire Hunter,67500000,37519139,137489730,175008869,107508869,en,12.498,2012-06-22,5.6,2009,2012,105.0,"Action,Fantasy,Horror",5.9,142853
66,Last Man Standing,67000000,18115927,18115927,36231854,-30768146,en,2.394,2011-06-07,4.4,11,2010,85.0,"Biography,Crime,Documentary",5.2,22
70,Need for Speed,66000000,43568507,194169619,237738126,171738126,en,13.723,2014-03-14,6.1,2389,2014,132.0,"Action,Crime,Thriller",6.5,154909
72,What Women Want,65000000,182805123,374105123,556910246,491910246,zh,1.917,2011-02-04,6.6,13,2011,116.0,"Comedy,Romance,Sci-Fi",5.6,1152
73,Lincoln,65000000,182207973,273346281,455554254,390554254,en,12.693,2012-11-16,6.8,2261,2012,150.0,"Biography,Drama,History",7.4,228701
77,Hotel Transylvania 3: Summer Vacation,65000000,167500092,527079962,694580054,629580054,en,26.815,2018-06-30,6.8,1673,2018,97.0,"Adventure,Animation,Comedy",6.3,42299
82,Unbroken,65000000,115637895,163527824,279165719,214165719,en,12.354,2014-12-25,7.4,2240,2014,137.0,"Biography,Drama,Sport",7.2,129981
84,Due Date,65000000,100539043,211739043,312278086,247278086,en,12.445,2010-11-04,6.3,2973,2010,95.0,"Adventure,Comedy",6.5,303523
89,Annie,65000000,85911262,139829625,225740887,160740887,en,13.422,2014-12-19,6.1,770,2014,118.0,"Comedy,Drama,Family",5.3,31241
94,The Kid,65000000,69688384,69688384,139376768,74376768,en,2.403,2010-10-31,6.9,12,2010,111.0,Drama,6.9,1206
96,The Dictator,65000000,59650222,180148897,239799119,174799119,en,12.592,2012-05-16,6.0,3042,2012,83.0,Comedy,6.4,250976
98,This Means War,65000000,54760791,156974557,211735348,146735348,en,12.017,2012-02-17,6.0,2096,2012,103.0,"Action,Comedy,Romance",6.3,167438
99,Focus,65000000,53862963,168065700,221928663,156928663,en,10.704,2015-02-27,6.8,4173,2015,105.0,"Comedy,Crime,Drama",6.6,192147
1,Red Dawn,65000000,44806783,48164150,92970933,27970933,en,13.904,2012-11-21,5.4,849,2012,93.0,"Action,Sci-Fi,Thriller",5.4,69599
3,Everest,65000000,43482270,221297061,264779331,199779331,en,19.9,2015-09-18,6.7,2874,2015,121.0,"Action,Adventure,Biography",7.1,181133
4,Resident Evil: Retribution,65000000,42345531,240647629,282993160,217993160,en,1.325,2012-09-14,5.7,2321,2012,95.0,"Action,Horror,Sci-Fi",5.4,125191
12,Elektra,65000000,24409722,56824633,81234355,16234355,en,0.6,2017-09-09,8.0,1,2010,,"Drama,Thriller",6.1,64
14,"I, Frankenstein",65000000,19075290,74575290,93650580,28650580,en,12.7,2014-01-24,5.2,1090,2014,92.0,"Action,Fantasy,Horror",5.1,74910
16,Sin City: A Dame to Kill For,65000000,13757804,40650842,54408646,-10591354,en,20.896,2014-08-22,6.3,2210,2014,102.0,"Crime,Thriller",6.5,140666
17,Live by Night,65000000,10378555,21774432,32152987,-32847013,en,11.322,2016-12-25,6.2,759,2016,129.0,"Action,Crime,Drama",6.4,47243
21,Air Strike,65000000,0,516279,516279,-64483721,en,6.971,2018-10-26,3.9,56,2018,120.0,"Action,Adventure,Drama",3.3,2536
27,Hop,63000000,108085305,188657593,296742898,233742898,en,14.738,2011-04-01,5.6,611,2011,95.0,"Adventure,Animation,Comedy",5.4,28893
28,American Assassin,63000000,36249674,68310140,104559814,41559814,en,15.434,2017-09-15,6.3,1596,2017,112.0,"Action,Thriller",6.2,57793
33,The Hateful Eight,62000000,54117416,147864886,201982302,139982302,en,20.681,2015-12-25,7.7,8065,2015,168.0,"Crime,Drama,Mystery",7.8,434966
36,Gone Girl,61000000,167767189,368567189,536334378,475334378,en,31.215,2014-10-03,7.9,10459,2014,149.0,"Drama,Mystery,Thriller",8.1,761592
38,Maze Runner: The Scorch Trials,61000000,81697192,310566162,392263354,331263354,en,17.31,2015-09-18,6.6,6365,2015,131.0,"Action,Sci-Fi,Thriller",6.3,201143
39,2 Guns,61000000,75612460,132493015,208105475,147105475,en,14.8,2013-08-02,6.5,2368,2013,109.0,"Action,Comedy,Crime",6.7,182025
44,The Lego Movie,60000000,257784718,457729388,715514106,655514106,en,19.375,2014-02-07,7.4,4839,2014,100.0,"Action,Adventure,Animation",7.8,304179
50,Sully,60000000,125070033,238524556,363594589,303594589,en,18.148,2016-09-09,7.1,3924,2016,96.0,"Biography,Drama",7.5,202718
63,Red,60000000,90380162,196439693,286819855,226819855,en,0.6,2014-01-01,5.0,1,2014,,Thriller,5.8,9
67,Eat Pray Love,60000000,80574010,206598789,287172799,227172799,en,9.991,2010-08-12,6.0,1208,2010,133.0,"Drama,Romance",5.8,77709
68,Jack Reacher,60000000,80070736,217370736,297441472,237441472,en,18.312,2012-12-21,6.4,4155,2012,130.0,"Action,Crime,Thriller",7.0,284547
71,Contagion,60000000,75658097,137551594,213209691,153209691,en,10.444,2011-09-09,6.3,2128,2011,106.0,"Action,Drama,Thriller",6.6,201536
80,London Has Fallen,60000000,62524260,195194085,257718345,197718345,en,15.287,2016-03-04,5.9,2591,2016,99.0,"Action,Thriller",5.9,124757
85,Jack Reacher: Never Go Back,60000000,58697076,159946489,218643565,158643565,en,17.085,2016-10-21,5.6,2831,2016,118.0,"Action,Thriller",6.1,121892
86,Baywatch,60000000,58060186,175863783,233923969,173923969,en,14.429,2017-05-26,6.1,4748,2017,116.0,"Action,Comedy,Crime",5.6,137528
88,Joy,60000000,56451232,101134059,157585291,97585291,en,10.305,2015-12-25,6.5,2723,2010,75.0,Drama,6.1,233
89,ParaNorman,60000000,56003051,108119662,164122713,104122713,en,13.32,2012-08-17,6.8,1358,2012,92.0,"Adventure,Animation,Comedy",7.0,87250
94,The Boxtrolls,60000000,50837305,111946251,162783556,102783556,en,11.219,2014-09-26,6.7,1016,2014,96.0,"Adventure,Animation,Comedy",6.8,50763
95,The Dark Tower,60000000,50701325,113461527,164162852,104162852,en,15.517,2017-08-04,5.6,2842,2017,95.0,"Action,Adventure,Fantasy",5.7,107518
97,Jack Ryan: Shadow Recruit,60000000,50577412,131377412,181954824,121954824,en,11.061,2014-01-17,6.1,1687,2014,105.0,"Action,Drama,Thriller",6.2,114913
100,Vice,60000000,47836282,70883171,118719453,58719453,en,14.641,2015-01-16,4.3,312,2015,96.0,"Action,Adventure,Sci-Fi",4.2,14436
4,Gangster Squad,60000000,46000903,104100903,150101806,90101806,en,13.029,2013-01-11,6.3,2527,2013,113.0,"Action,Crime,Drama",6.7,195560
5,Smurfs: The Lost Village,60000000,45020282,197578586,242598868,182598868,en,15.663,2017-04-07,6.2,736,2017,90.0,"Adventure,Animation,Comedy",6.0,15612
6,First Man,60000000,44936545,105203825,150140370,90140370,en,22.958,2018-10-12,7.1,2304,2018,141.0,"Biography,Drama,History",7.4,120009
8,Edge of Darkness,60000000,43313890,82812456,126126346,66126346,en,11.252,2010-01-29,6.3,794,2010,117.0,"Crime,Drama,Mystery",6.6,84753
15,State of Play,60000000,37017955,88832210,125850165,65850165,en,0.6,2013-09-09,6.0,3,2013,87.0,"Documentary,Drama,Sport",6.5,156
18,Trouble with the Curve,60000000,35763137,47818913,83582050,23582050,en,8.548,2012-09-21,6.7,613,2012,111.0,"Drama,Sport",6.8,56129
22,Almost Famous,60000000,32522352,47371191,79893543,19893543,en,11.022,2000-09-15,7.5,1339,2017,95.0,"Comedy,Drama,Family",4.1,23
26,The Mortal Instruments: City of Bones,60000000,31165421,75965567,107130988,47130988,en,16.484,2013-08-21,6.3,2915,2013,130.0,"Action,Fantasy,Horror",5.9,121936
28,Dragonfly,60000000,30063805,30063805,60127610,127610,en,0.664,2016-04-10,3.0,2,2015,80.0,"Crime,Drama,Thriller",6.3,40
29,Priest,60000000,29136626,84154026,113290652,53290652,en,15.318,2011-05-13,5.5,1157,2011,87.0,"Action,Adventure,Fantasy",5.7,108320
47,Rock Dog,60000000,9420546,24148488,33569034,-26430966,en,10.362,2017-02-24,5.7,123,2016,90.0,"Adventure,Animation,Comedy",5.9,3991
48,Mortdecai,60000000,7696134,30396134,38092268,-21907732,en,13.263,2015-01-23,5.4,1666,2015,107.0,"Action,Comedy,Crime",5.5,61366
52,The Ridiculous 6,60000000,0,0,0,-60000000,en,10.187,2015-12-11,5.0,676,2015,119.0,"Comedy,Western",4.8,38694
54,Sherlock Gnomes,59000000,43242871,87527651,130770522,71770522,en,12.987,2018-03-23,5.4,343,2018,86.0,"Adventure,Animation,Comedy",5.1,8030
56,Deadpool,58000000,363070709,801025593,1164096302,1106096302,en,35.067,2016-02-12,7.6,20175,2016,108.0,"Action,Adventure,Comedy",8.0,820847
57,American Sniper,58000000,350126372,547326372,897452744,839452744,en,18.473,2014-12-25,7.4,7658,2014,133.0,"Action,Biography,Drama",7.3,401915
58,Goosebumps,58000000,80069458,158905324,238974782,180974782,en,18.957,2015-10-16,6.2,2147,2015,103.0,"Adventure,Comedy,Family",6.3,72858
61,Red Tails,58000000,49876377,50365498,100241875,42241875,en,10.247,2012-01-11,6.0,256,2012,125.0,"Action,Adventure,Drama",5.9,31815
63,The Internship,58000000,44672764,93672764,138345528,80345528,en,0.6,2013-06-07,6.2,2631,2013,119.0,Comedy,6.3,179817
70,Resident Evil: Afterlife,57500000,60128566,295874190,356002756,298502756,en,0.667,2010-09-10,5.9,2119,2010,96.0,"Action,Adventure,Horror",5.9,153270
71,That's My Boy,57500000,36931089,58085235,95016324,37516324,en,12.817,2012-06-15,5.5,831,2012,116.0,Comedy,5.6,83009
73,Ghost Rider: Spirit of Vengeance,57000000,51774002,149217355,200991357,143991357,en,18.678,2011-12-10,4.8,2039,2011,96.0,"Action,Fantasy,Thriller",4.3,103608
77,Into the Woods,56200000,128002372,213116401,341118773,284918773,en,13.726,2014-12-25,5.7,2880,2014,125.0,"Adventure,Comedy,Drama",6.0,123577
84,Bohemian Rhapsody,55000000,216303339,894985342,1111288681,1056288681,en,37.197,2018-11-02,8.1,7629,2018,134.0,"Biography,Drama,Music",8.0,345466
91,Fifty Shades Darker,55000000,114434010,381398492,495832502,440832502,en,12.083,2017-02-10,6.1,4489,2017,118.0,"Drama,Romance",4.6,81706
92,Captain Phillips,55000000,107136417,220648184,327784601,272784601,en,15.483,2013-10-11,7.6,3909,2013,134.0,"Biography,Drama,Thriller",7.8,387402
95,Murder on the Orient Express,55000000,102826543,345922730,448749273,393749273,en,15.937,2017-11-10,6.7,5406,2017,114.0,"Crime,Drama,Mystery",6.5,178603
96,The Equalizer,55000000,101530738,192903624,294434362,239434362,en,28.942,2014-09-26,7.2,4989,2014,132.0,"Action,Crime,Thriller",7.2,302302
97,Fifty Shades Freed,55000000,100407760,371350619,471758379,416758379,en,22.512,2018-02-09,6.1,3535,2018,105.0,"Drama,Romance,Thriller",4.5,43893
99,Date Night,55000000,98711404,152269033,250980437,195980437,en,12.498,2010-04-08,6.0,1743,2010,88.0,"Comedy,Crime,Romance",6.3,144683
5,Paddington,55000000,76223578,258789097,335012675,280012675,en,13.565,2015-01-16,7.0,1904,2014,95.0,"Adventure,Comedy,Family",7.2,84679
16,Free Birds,55000000,55750480,110387072,166137552,111137552,en,11.062,2013-11-01,5.8,410,2013,91.0,"Adventure,Animation,Comedy",5.9,20934
20,Muppets Most Wanted,55000000,51178893,79312301,130491194,75491194,en,9.118,2014-03-21,6.2,473,2014,107.0,"Adventure,Comedy,Crime",6.4,29018
22,Kubo and the Two Strings,55000000,48023088,77548122,125571210,70571210,en,13.847,2016-08-19,7.7,2029,2016,101.0,"Action,Adventure,Animation",7.8,105578
24,Burlesque,55000000,39440655,90552675,129993330,74993330,en,8.676,2010-11-23,7.1,1195,2010,119.0,"Drama,Music,Musical",6.4,71021
27,The Watch,55000000,34353000,67130045,101483045,46483045,en,10.228,2012-07-27,5.4,1356,2012,102.0,"Action,Comedy,Horror",5.7,115757
28,The Hunted,55000000,34234008,47213095,81447103,26447103,en,2.897,2014-09-09,5.2,10,2015,90.0,"Action,Comedy,Horror",6.5,53
32,Annihilation,55000000,32732301,43070915,75803216,20803216,en,25.197,2018-02-23,6.3,4465,2018,115.0,"Adventure,Drama,Horror",6.9,228664
33,Crimson Peak,55000000,31090320,74966854,106057174,51057174,en,9.897,2015-10-16,6.5,2986,2015,119.0,"Drama,Fantasy,Horror",6.5,119287
41,Turbulence,55000000,11532774,11532774,23065548,-31934452,en,1.073,2016-12-01,5.6,5,2011,90.0,Comedy,8.2,34
42,Bullet to the Head,55000000,9489829,22597969,32087798,-22912202,en,17.574,2013-02-01,5.4,681,2012,92.0,"Action,Crime,Thriller",5.7,44816
59,Black Mass,53000000,62575678,98837872,161413550,108413550,en,14.646,2015-09-18,6.4,2020,2015,123.0,"Biography,Crime,Drama",6.9,155847
65,Beloved,53000000,22852487,22852487,45704974,-7295026,fr,5.599,2011-08-17,6.7,31,2010,107.0,Comedy,6.4,506
66,Zero Dark Thirty,52500000,95720716,134612435,230333151,177833151,en,14.239,2012-12-19,6.9,2553,2012,157.0,"Drama,Thriller",7.4,251072
70,Valentine's Day,52000000,110485654,217569328,328054982,276054982,en,11.187,2010-02-11,5.8,1907,2010,125.0,"Comedy,Romance",5.7,107171
72,The Change-Up,52000000,37243418,75997067,113240485,61240485,en,12.122,2011-08-05,6.0,1406,2011,112.0,"Comedy,Fantasy",6.3,155374
79,Alpha,51000000,35851379,99624873,135476252,84476252,el,0.84,2015-01-25,7.0,1,2013,116.0,Crime,5.5,102
81,The Adjustment Bureau,50200000,62495645,126931325,189426970,139226970,en,13.717,2011-03-04,6.6,2615,2011,106.0,"Romance,Sci-Fi,Thriller",7.1,227616
84,Ted,50000000,218665740,556016627,774682367,724682367,en,14.475,2012-06-29,6.3,7727,2012,106.0,"Comedy,Fantasy",6.9,538367
85,22 Jump Street,50000000,191719337,331333876,523053213,473053213,en,11.176,2014-06-13,6.9,5167,2014,112.0,"Action,Comedy,Crime",7.0,319504
91,Central Intelligence,50000000,127440871,217194805,344635676,294635676,en,14.478,2016-06-17,6.3,3133,2016,107.0,"Action,Comedy,Crime",6.3,138872
92,Anchorman 2: The Legend Continues,50000000,127352707,172185754,299538461,249538461,en,12.08,2013-12-18,6.1,1408,2013,119.0,Comedy,6.3,156116
93,Super 8,50000000,127004179,257972745,384976924,334976924,en,14.39,2011-06-09,6.7,3934,2011,112.0,"Mystery,Sci-Fi,Thriller",7.0,320575
96,Creed II,50000000,115715889,213591522,329307411,279307411,en,26.907,2018-11-21,6.7,2236,2018,130.0,"Drama,Sport",7.2,72503
97,Peter Rabbit,50000000,115234093,347136477,462370570,412370570,en,15.974,2018-02-09,6.5,650,2018,95.0,"Adventure,Animation,Comedy",6.6,27908
100,The Mule,50000000,103804407,170857676,274662083,224662083,en,6.161,2014-03-10,6.4,77,2013,100.0,"Comedy,Drama",6.2,653
2,Non-Stop,50000000,91742160,222383055,314125215,264125215,en,2.264,2013-11-29,5.6,23,2014,106.0,"Action,Mystery,Thriller",7.0,234717
7,The Emoji Movie,50000000,86089513,216562312,302651825,252651825,en,14.88,2017-07-23,5.4,1447,2017,86.0,"Adventure,Animation,Comedy",3.2,47294
9,The Post,50000000,81903458,179748880,261652338,211652338,en,15.551,2017-12-22,7.0,2506,2017,116.0,"Biography,Drama,History",7.2,108017
10,Payback,50000000,81526121,161626121,243152242,193152242,en,0.84,2012-03-16,5.0,1,2012,82.0,Documentary,6.4,186
14,We Bought a Zoo,50000000,75624550,118729073,194353623,144353623,en,9.931,2011-12-23,6.7,1523,2011,124.0,"Comedy,Drama,Family",7.1,126849
15,Moneyball,50000000,75605492,111300835,186906327,136906327,en,15.393,2011-09-22,7.1,2255,2011,133.0,"Biography,Drama,Sport",7.6,326657
26,American Reunion,50000000,56758835,236799211,293558046,243558046,en,17.199,2012-04-06,6.2,2679,2012,113.0,Comedy,6.7,192250
27,Hansel & Gretel: Witch Hunters,50000000,55703475,214949716,270653191,220653191,en,15.982,2013-01-25,5.9,4548,2013,88.0,"Action,Fantasy,Horror",6.1,183387
32,American Made,50000000,51342000,135569212,186911212,136911212,en,16.748,2017-09-29,6.7,2188,2017,115.0,"Action,Biography,Comedy",7.2,131043
35,The Book of Life,50000000,50151543,97651543,147803086,97803086,en,11.392,2014-10-17,7.4,1228,2014,95.0,"Adventure,Animation,Comedy",7.3,59486
40,Into the Storm,50000000,47602194,150429371,198031565,148031565,en,8.884,2014-08-08,5.8,1169,2014,89.0,"Action,Adventure,Drama",5.8,60894
41,The Judge,50000000,47119388,76119388,123238776,73238776,en,16.464,2014-10-10,7.3,2356,2014,141.0,"Crime,Drama",7.4,162952
45,War Dogs,50000000,43034523,86234503,129269026,79269026,en,10.654,2016-08-19,6.8,2387,2016,114.0,"Comedy,Crime,Drama",7.1,154029
56,The Nice Guys,50000000,36261763,59596747,95858510,45858510,en,13.743,2016-05-20,7.1,4272,2016,116.0,"Action,Comedy,Crime",7.4,240337
59,Marmaduke,50000000,33644788,89895930,123540718,73540718,en,8.487,2010-06-04,5.1,367,2010,87.0,"Comedy,Family",4.2,13283
61,Hereafter,50000000,32746941,108660270,141407211,91407211,en,7.886,2010-10-22,5.9,848,2010,129.0,"Drama,Fantasy,Romance",6.5,87288
63,Assassins,50000000,30306268,83306268,113612536,63612536,en,10.579,1995-10-06,6.2,666,2014,84.0,"Action,Drama,Thriller",4.4,73
64,Zoolander 2,50000000,28848693,55348693,84197386,34197386,en,12.997,2016-02-12,4.7,1374,2016,101.0,Comedy,4.7,59914
68,The Host,50000000,26623701,64477051,91100752,41100752,en,11.458,2013-03-29,6.2,2788,2013,125.0,"Action,Adventure,Drama",5.9,105633
70,Run All Night,50000000,26461644,66961644,93423288,43423288,en,17.592,2015-03-13,6.4,1684,2015,114.0,"Action,Drama,Thriller",6.6,94131
78,Your Highness,50000000,21596445,26121638,47718083,-2281917,en,0.6,2010-01-01,3.0,4,2011,102.0,"Adventure,Comedy,Fantasy",5.5,92940
79,Snowden,50000000,21587519,35380918,56968437,6968437,en,13.703,2016-09-16,7.1,2427,2016,134.0,"Biography,Drama,Thriller",7.3,119149
80,Dream House,50000000,21302340,41642166,62944506,12944506,en,9.047,2011-09-30,6.0,670,2011,84.0,"Drama,Mystery,Thriller",6.0,59714
81,Free State of Jones,50000000,20810036,23237252,44047288,-5952712,en,8.574,2016-06-24,6.6,787,2016,139.0,"Action,Biography,Drama",6.9,45135
85,Beautiful Creatures,50000000,19452138,60282876,79735014,29735014,en,11.198,2013-02-14,5.7,1826,2013,124.0,"Drama,Fantasy,Romance",6.2,79764
90,Fair Game,50000000,11497497,26097497,37594994,-12405006,en,11.624,2010-05-20,6.6,384,2010,108.0,"Biography,Drama,Thriller",6.8,43862
91,Drive Angry,50000000,10721033,41042583,51763616,1763616,en,14.096,2011-02-24,5.3,959,2011,104.0,"Action,Fantasy,Thriller",5.4,90203
98,Early Man,50000000,8267544,45285890,53553434,3553434,en,16.675,2018-02-16,5.9,338,2018,89.0,"Adventure,Animation,Comedy",6.1,15882
2,Child 44,50000000,1224330,8004221,9228551,-40771449,en,26.386,2015-04-17,6.2,903,2015,137.0,"Crime,Drama,History",6.5,59477
4,Upside Down,50000000,102118,26387039,26489157,-23510843,en,12.454,2013-03-14,6.2,1645,2012,109.0,"Drama,Fantasy,Romance",6.4,66347
5,Shanghai,50000000,46425,15505922,15552347,-34447653,en,6.824,2010-10-02,6.1,80,2010,105.0,"Crime,Drama,Mystery",6.4,8662
10,The One,49000000,43905746,72689126,116594872,67594872,en,0.931,2011-10-07,5.5,5,2011,89.0,"Comedy,Drama,Romance",5.0,681
11,Chappie,49000000,31569268,105002056,136571324,87571324,en,24.52,2015-03-06,6.7,4995,2015,120.0,"Action,Crime,Drama",6.8,213733
13,Anna Karenina,49000000,12816367,71004627,83820994,34820994,en,9.987,2012-11-16,6.7,1265,2012,129.0,"Drama,Romance",6.6,84668
18,Taken 3,48000000,89256424,327656424,416912848,368912848,en,27.679,2015-01-09,6.1,3406,2014,108.0,"Action,Thriller",6.0,165072
20,Instant Family,48000000,67363237,119736188,187099425,139099425,en,22.634,2018-11-16,7.6,782,2018,118.0,"Comedy,Drama",7.4,46728
23,Tooth Fairy,48000000,60022256,112610386,172632642,124632642,en,12.65,2010-01-22,5.3,1058,2010,101.0,"Comedy,Family,Fantasy",5.0,37939
32,The Infiltrator,47500000,15436808,20718104,36154912,-11345088,en,9.588,2016-07-13,6.6,943,2016,127.0,"Biography,Crime,Drama",7.0,61547
34,Arrival,47000000,100546139,203127894,303674033,256674033,en,25.442,2016-11-11,7.4,10387,2016,116.0,"Drama,Mystery,Sci-Fi",7.9,515483
40,Jonah Hex,47000000,10547117,11022696,21569813,-25430187,en,13.467,2010-06-18,4.6,708,2010,81.0,"Action,Drama,Fantasy",4.7,51860
42,Silence,46500000,7100177,23726626,30826803,-15673197,en,10.617,2016-12-23,7.1,1560,2016,161.0,"Adventure,Drama,History",7.2,85242
44,My Best Friend's Wedding,46000000,126813153,298923419,425736572,379736572,zh,1.4,2016-08-12,7.0,2,2016,91.0,"Comedy,Romance",5.0,162
48,Prisoners,46000000,61002302,113402302,174404604,128404604,en,14.358,2013-09-21,8.0,5785,2013,153.0,"Crime,Drama,Mystery",8.1,526273
54,Taken 2,45000000,139854287,377807404,517661691,472661691,en,16.078,2012-10-04,6.2,4035,2012,92.0,"Action,Thriller",6.3,273106
58,Pitch Perfect 3,45000000,104897530,185736412,290633942,245633942,en,14.89,2017-12-22,6.5,1884,2017,93.0,"Comedy,Music",5.8,45127
64,The Muppets,45000000,88625922,160971922,249597844,204597844,en,11.324,2011-11-23,6.6,831,2011,103.0,"Adventure,Comedy,Family",7.1,82752
68,The Girl on the Train,45000000,75395035,174278214,249673249,204673249,en,1.595,2014-07-03,5.9,25,2013,80.0,Thriller,4.4,819
73,The Bounty Hunter,45000000,67061228,135808837,202870065,157870065,en,9.861,2010-03-19,5.7,1627,2010,110.0,"Action,Comedy,Romance",5.6,112444
81,Office Christmas Party,45000000,54767494,91323299,146090793,101090793,en,10.729,2016-12-09,5.6,1191,2016,105.0,Comedy,5.8,59253
88,Savages,45000000,47323100,82513490,129836590,84836590,en,7.504,2012-07-06,6.3,1246,2012,131.0,"Crime,Drama,Thriller",6.5,115793
90,Blended,45000000,46290741,127990741,174281482,129281482,en,10.613,2014-05-23,6.7,1709,2014,117.0,"Comedy,Romance",6.5,106491
91,All Eyez on Me,45000000,44922302,54876855,99799157,54799157,en,7.249,2017-06-16,6.4,695,2017,139.0,"Biography,Drama,Music",5.8,18541
3,Frankenstein,45000000,22006296,112006296,134012592,89012592,en,3.989,2015-08-15,5.8,51,2011,130.0,Drama,9.0,1832
7,The Pledge,45000000,19719930,29406132,49126062,4126062,en,0.6,2011-08-01,6.0,1,2011,118.0,"Drama,Family",6.3,164
10,Rebound,45000000,16809014,17492014,34301028,-10698972,en,0.914,2014-06-23,3.4,7,2014,84.0,"Horror,Mystery,Thriller",4.2,259
11,The Ghost Writer,45000000,15541549,65532491,81074040,36074040,en,7.829,2010-02-12,6.8,1135,2010,128.0,"Drama,Mystery,Thriller",7.2,148274
15,Dredd,45000000,13414714,41467606,54882320,9882320,en,13.223,2012-09-21,6.7,2788,2012,95.0,"Action,Crime,Sci-Fi",7.1,234616
16,The Rum Diary,45000000,13109815,21544732,34654547,-10345453,en,12.011,2011-10-27,5.7,652,2011,119.0,"Comedy,Drama",6.2,94787
18,Welcome to Marwen,45000000,10763520,12874922,23638442,-21361558,en,22.032,2018-12-21,6.6,286,2018,116.0,"Biography,Comedy,Drama",6.1,8920
19,Johnny English Reborn,45000000,8406711,164640401,173047112,128047112,en,15.542,2011-10-21,6.1,1810,2011,101.0,"Action,Adventure,Comedy",6.3,110824
26,Foodfight!,45000000,0,73706,73706,-44926294,en,4.705,2013-05-07,2.1,46,2012,91.0,"Action,Animation,Comedy",1.9,8248
27,Argo,44500000,136025503,227140757,363166260,318666260,en,15.793,2012-10-12,7.2,5127,2012,120.0,"Biography,Drama,Thriller",7.7,534683
31,Charlie St. Cloud,44000000,31206263,48478084,79684347,35684347,en,9.454,2010-05-01,6.9,1398,2010,99.0,"Drama,Fantasy,Romance",6.5,55016
33,The Interview,44000000,6105175,12342632,18447807,-25552193,en,15.501,2014-12-25,6.2,3579,2014,112.0,Comedy,6.5,286341
35,The Heat,43000000,159581587,229727774,389309361,346309361,en,16.912,2013-06-28,6.6,2441,2013,117.0,"Action,Comedy,Crime",6.6,153501
41,A Monster Calls,43000000,3740823,46414530,50155353,7155353,en,11.128,2016-12-23,7.1,1918,2016,108.0,"Animation,Drama,Fantasy",7.5,70416
42,The Mechanic,42500000,29121498,76347393,105468891,62968891,en,14.387,2011-01-28,6.3,1676,2011,93.0,"Action,Crime,Thriller",6.6,141254
44,21 Jump Street,42000000,138447667,202812429,341260096,299260096,en,14.836,2012-03-12,6.8,6527,2012,109.0,"Action,Comedy,Crime",7.2,477771
51,Snatched,42000000,45852178,57852177,103704355,61704355,en,0.725,2011-01-01,3.5,2,2011,81.0,Comedy,5.5,61
52,Here Comes the Boom,42000000,45290318,73239258,118529576,76529576,en,10.265,2012-10-12,6.0,812,2012,105.0,"Action,Comedy,Sport",6.4,81761
55,Red Riding Hood,42000000,37662162,91678442,129340604,87340604,en,11.856,2011-03-11,5.9,1884,2011,100.0,"Fantasy,Horror,Mystery",5.5,102369
58,Holmes & Watson,42000000,30568743,41926605,72495348,30495348,en,19.331,2018-12-25,4.1,217,2018,90.0,"Adventure,Comedy,Crime",3.8,17661
59,One for the Money,42000000,26414527,36197221,62611748,20611748,en,8.62,2012-01-27,5.5,615,2012,91.0,"Action,Comedy,Crime",5.3,38473
63,Hero,42000000,19487173,66787173,86274346,44274346,en,0.6,2014-04-17,9.0,1,2014,,Drama,6.4,21
64,Man on a Ledge,42000000,18620000,49621440,68241440,26241440,en,11.263,2012-01-27,6.3,1460,2012,102.0,"Action,Adventure,Crime",6.6,137507
65,The Warrior's Way,42000000,5666340,8514325,14180665,-27819335,en,8.259,2010-12-03,6.1,203,2010,100.0,"Action,Fantasy,Western",6.3,24271
74,The Big Year,41000000,7204138,7684524,14888662,-26111338,en,7.077,2011-10-14,5.8,393,2011,100.0,Comedy,6.2,39522
77,The Karate Kid,40000000,176591618,351774938,528366556,488366556,en,12.256,2010-06-10,6.3,3140,2010,140.0,"Action,Drama,Family",6.2,146401
78,Fifty Shades of Grey,40000000,166167230,570998101,737165331,697165331,en,21.229,2015-02-13,5.4,6451,2015,125.0,"Drama,Romance,Thriller",4.1,279126
80,American Hustle,40000000,150117807,257878294,407996101,367996101,en,12.481,2013-12-12,6.8,4443,2013,138.0,"Crime,Drama",7.2,418221
83,Lucy,40000000,126573960,457507776,584081736,544081736,en,16.73,2014-07-25,6.3,10019,2014,89.0,"Action,Sci-Fi,Thriller",6.4,403194
84,Lone Survivor,40000000,125095601,149804632,274900233,234900233,en,15.404,2013-12-24,7.4,2289,2013,121.0,"Action,Biography,Drama",7.5,246641
91,The Social Network,40000000,96962694,224922135,321884829,281884829,en,15.889,2010-10-01,7.2,6116,2010,120.0,"Biography,Drama",7.7,568578
95,Ride Along 2,40000000,90862685,124827316,215690001,175690001,en,12.977,2016-01-15,6.2,939,2016,102.0,"Action,Comedy,Crime",5.9,48688
97,Get Hard,40000000,90411453,106511453,196922906,156922906,en,12.129,2015-03-27,6.0,1469,2015,100.0,"Comedy,Crime",6.0,111187
100,The Accountant,40000000,86260045,152962083,239222128,199222128,en,13.81,2016-10-14,6.9,3407,2016,128.0,"Action,Crime,Drama",7.3,233022
1,Dumb and Dumber To,40000000,86208010,156553592,242761602,202761602,en,15.964,2014-11-14,5.5,1842,2014,109.0,"Adventure,Comedy",5.6,118646
2,The Other Woman,40000000,83911193,195111193,279022386,239022386,en,9.15,2011-02-04,6.2,220,2014,109.0,"Comedy,Romance",6.0,122889
6,The Intern,40000000,75764672,197115710,272880382,232880382,en,14.377,2015-09-25,7.1,3373,2010,65.0,,5.5,22
10,Bridge of Spies,40000000,72313754,162498338,234812092,194812092,en,12.836,2015-10-16,7.2,4313,2015,142.0,"Drama,History,Thriller",7.6,263004
17,Hacksaw Ridge,40000000,67209615,168904682,236114297,196114297,en,24.074,2016-11-04,8.1,6608,2016,139.0,"Biography,Drama,History",8.1,366904
21,Unknown,40000000,63686397,136123083,199809480,159809480,en,12.08,2011-02-18,6.6,2043,2011,113.0,"Action,Mystery,Thriller",6.9,235167
22,Get Him to the Greek,40000000,61153526,91455875,152609401,112609401,en,8.485,2010-06-04,5.9,980,2010,109.0,"Adventure,Comedy,Music",6.4,161653
25,The Lincoln Lawyer,40000000,58009200,87145086,145154286,105154286,en,11.812,2011-03-18,7.1,1525,2011,118.0,"Crime,Drama,Thriller",7.3,196109
31,Horrible Bosses 2,40000000,54445357,105945357,160390714,120390714,en,18.421,2014-11-26,6.2,2581,2014,108.0,"Comedy,Crime",6.3,144442
35,Predators,40000000,52000688,127234389,179235077,139235077,en,16.216,2010-07-03,6.1,1979,2010,107.0,"Action,Adventure,Sci-Fi",6.4,199764
36,The Odd Life of Timothy Green,40000000,51853450,55249159,107102609,67102609,en,9.216,2012-08-15,6.7,605,2012,105.0,"Comedy,Drama,Family",6.6,42770
43,Jersey Boys,40000000,47047013,65282732,112329745,72329745,en,6.933,2014-06-20,6.9,380,2014,134.0,"Biography,Drama,Music",6.8,30410
49,Final Destination 5,40000000,42587643,155011165,197598808,157598808,en,13.392,2011-08-12,6.0,1701,2011,92.0,Horror,5.9,98061
50,Widows,40000000,42402632,73866088,116268720,76268720,en,20.628,2018-11-16,6.5,941,2011,100.0,"Comedy,Drama",6.3,484
54,Sex Tape,40000000,38543473,126069509,164612982,124612982,en,20.429,2014-07-18,5.3,2684,2014,94.0,"Comedy,Romance",5.1,100520
55,Scream 4,40000000,38180928,95989590,134170518,94170518,en,16.082,2011-04-11,6.2,1610,2011,111.0,"Horror,Mystery",6.2,118779
58,Paul,40000000,37412945,101162106,138575051,98575051,en,15.234,2011-03-17,6.5,3017,2011,104.0,"Adventure,Comedy,Sci-Fi",7.0,220567
59,The Guilt Trip,40000000,37134215,41294674,78428889,38428889,en,8.939,2012-12-19,5.4,403,2012,95.0,"Comedy,Drama",5.8,33702
60,Colombiana,40000000,36665854,72295262,108961116,68961116,en,10.584,2011-08-26,6.5,1371,2011,108.0,"Action,Drama,Thriller",6.4,87659
62,The Commuter,40000000,36343858,101985431,138329289,98329289,en,20.063,2018-01-12,6.2,2394,2018,105.0,"Action,Mystery,Thriller",6.3,83114
67,Arthur,40000000,33035397,47787943,80823340,40823340,en,7.886,2011-04-08,5.5,399,2011,110.0,"Comedy,Romance",5.7,49013
69,Patriots Day,40000000,31886361,52837989,84724350,44724350,en,15.435,2016-12-21,6.9,1337,2016,133.0,"Action,Crime,Drama",7.4,76204
73,Morning Glory,40000000,31011732,59795070,90806802,50806802,en,10.595,2010-11-10,6.3,717,2010,107.0,"Comedy,Drama,Romance",6.5,67367
75,Long Shot,40000000,30202860,43711031,73913891,33913891,en,5.034,2017-09-03,7.2,39,2019,125.0,"Comedy,Romance",7.2,12814
77,Grudge Match,40000000,29807260,69807260,99614520,59614520,en,7.918,2013-12-25,6.0,711,2013,113.0,"Comedy,Drama,Sport",6.4,54080
81,The Nut Job 2: Nutty by Nature,40000000,28370522,57438389,85808911,45808911,en,8.975,2017-08-11,5.7,227,2017,91.0,"Adventure,Animation,Comedy",5.5,4820
84,Resident Evil: The Final Chapter,40000000,26844692,314101190,340945882,300945882,en,0.844,2017-01-27,5.9,1859,2016,107.0,"Action,Horror,Sci-Fi",5.6,74979
86,The House,40000000,25584504,31192425,56776929,16776929,en,9.62,2017-06-30,5.7,474,2011,109.0,"Drama,Mystery,Thriller",4.6,50
89,Season of the Witch,40000000,24827228,91126600,115953828,75953828,en,12.535,2011-01-07,5.3,1352,2011,95.0,"Action,Adventure,Fantasy",5.4,85777
94,Mechanic: Resurrection,40000000,21218403,109738840,130957243,90957243,en,16.302,2016-08-26,5.6,1929,2016,98.0,"Action,Adventure,Thriller",5.7,67275
99,Big Miracle,40000000,20157300,25268680,45425980,5425980,en,6.76,2012-02-03,6.6,250,2012,107.0,"Biography,Drama,Family",6.5,17585
100,The Impossible,40000000,19019882,169590606,188610488,148610488,en,14.66,2012-12-04,7.2,3614,2012,114.0,"Drama,History,Thriller",7.6,177762
1,A Thousand Words,40000000,18450127,20790486,39240613,-759387,en,8.017,2012-03-08,6.1,685,2012,91.0,"Comedy,Drama",5.9,36387
15,The Gunman,40000000,10664749,18594227,29258976,-10741024,en,10.388,2015-03-20,5.7,583,2015,115.0,"Action,Crime,Drama",5.8,36053
19,Paranoia,40000000,7388654,16340767,23729421,-16270579,en,0.6,2011-06-07,4.5,2,2013,106.0,"Drama,Thriller",5.7,33149
22,The Hurricane Heist,40000000,6115824,30963684,37079508,-2920492,en,13.335,2018-03-09,5.4,476,2018,103.0,"Action,Adventure,Crime",5.1,15326
24,Victor Frankenstein,40000000,5775076,31124367,36899443,-3100557,en,9.061,2015-11-10,5.8,1200,2015,110.0,"Drama,Horror,Sci-Fi",6.0,47492
27,Snowpiercer,40000000,4563029,88069880,92632909,52632909,ko,14.735,2014-06-27,6.8,4748,2013,126.0,"Action,Drama,Sci-Fi",7.1,239264
40,USS Indianapolis: Men of Courage,40000000,0,1663785,1663785,-38336215,en,11.221,2017-01-24,5.9,328,2016,128.0,"Action,Drama,History",5.2,9453
48,Frankenweenie,39000000,35287788,81150788,116438576,77438576,en,14.627,2012-10-05,6.8,1685,2012,87.0,"Animation,Comedy,Family",7.0,89489
59,Captain Underpants: The First Epic Movie,38000000,73921000,126577874,200498874,162498874,en,18.31,2017-06-02,6.0,587,2017,89.0,"Action,Animation,Comedy",6.2,21903
60,Paul Blart: Mall Cop 2,38000000,71091594,107650646,178742240,140742240,en,15.941,2015-04-17,5.0,900,2015,94.0,"Action,Comedy,Crime",4.4,30828
62,Why Him?,38000000,60323786,117425156,177748942,139748942,en,15.044,2016-12-23,6.2,2494,2016,111.0,Comedy,6.2,89628
63,Water for Elephants,38000000,58709717,116809717,175519434,137519434,en,6.209,2011-04-22,6.9,1627,2011,120.0,"Drama,Romance",6.9,105812
66,Riddick,38000000,42025135,94763758,136788893,98788893,en,17.434,2013-09-06,6.2,2852,2013,119.0,"Action,Adventure,Sci-Fi",6.4,144821
69,The 5th Wave,38000000,34912982,111336398,146249380,108249380,en,12.967,2016-01-15,5.8,3657,2016,112.0,"Action,Adventure,Drama",5.2,90788
71,Rush,38000000,26947624,98230839,125178463,87178463,en,14.623,2013-09-27,7.7,3877,2013,123.0,"Action,Biography,Drama",8.1,393437
75,Only the Brave,38000000,18340051,24555177,42895228,4895228,en,14.163,2017-10-20,7.0,603,2017,134.0,"Action,Biography,Drama",7.7,45482
77,The Thing,38000000,16999934,27573078,44573012,6573012,en,12.349,2011-10-14,6.1,1404,2011,103.0,"Horror,Mystery,Sci-Fi",6.2,111900
82,The Sisters Brothers,38000000,3143056,13143056,16286112,-21713888,en,13.738,2018-09-21,7.0,590,2018,122.0,"Adventure,Comedy,Crime",7.0,32135
85,The Upside,37500000,108235497,119024536,227260033,189760033,en,28.138,2019-01-11,7.3,274,2017,126.0,"Comedy,Drama",6.7,24169
86,What to Expect When You're Expecting,37500000,41152203,88473016,129625219,92125219,en,12.27,2012-05-18,5.9,1130,2012,110.0,"Comedy,Drama,Romance",5.7,65890
87,The Master,37500000,16247159,50647416,66894575,29394575,en,12.829,2012-09-14,7.1,1323,2012,138.0,Drama,7.1,131365
90,We're the Millers,37000000,150394119,267816276,418210395,381210395,en,14.746,2013-08-07,6.8,5231,2013,110.0,"Comedy,Crime",7.0,371759
91,Creed,37000000,109767581,173567581,283335162,246335162,en,16.356,2015-11-25,7.3,4010,2010,77.0,Horror,6.6,12
92,The Town,37000000,92186262,152566881,244753143,207753143,en,13.476,2010-09-17,7.1,2386,2010,125.0,"Crime,Drama,Thriller",7.6,322524
93,Dolphin Tale,37000000,72286779,96068724,168355503,131355503,en,10.679,2011-09-23,6.8,327,2011,113.0,"Drama,Family",6.9,20746
94,Game Night,37000000,69179066,117378084,186557150,149557150,en,19.459,2018-02-23,6.9,2756,2018,100.0,"Action,Comedy,Crime",7.0,163279
99,Cop Out,37000000,44875481,55909910,100785391,63785391,en,8.82,2010-02-26,5.4,796,2010,107.0,"Action,Comedy,Crime",5.6,81656
100,The Rite,37000000,33047633,97143987,130191620,93191620,en,9.676,2011-01-28,5.9,994,2011,114.0,"Drama,Horror,Mystery",6.0,85604
3,Aloha,37000000,21052030,25387091,46439121,9439121,en,9.685,2015-05-29,5.3,1226,2015,105.0,"Comedy,Drama,Romance",5.4,54646
10,Hot Tub Time Machine,36000000,50269859,65967750,116237609,80237609,en,10.15,2010-03-26,6.0,1383,2010,101.0,"Comedy,Sci-Fi",6.4,153962
12,Dolphin Tale 2,36000000,42024533,57824533,99849066,63849066,en,7.403,2014-09-12,6.7,173,2014,107.0,"Drama,Family",6.4,7579
13,Collateral Beauty,36000000,31016021,85309093,116325114,80325114,en,12.857,2016-12-16,7.2,3270,2016,97.0,"Drama,Romance",6.8,78764
21,There Be Dragons,36000000,1069334,4020990,5090324,-30909676,en,7.058,2011-05-06,5.1,93,2011,122.0,"Biography,Drama,War",5.8,4326
22,Queen of the Desert,36000000,0,1578543,1578543,-34421457,en,7.109,2016-03-01,6.0,136,2015,128.0,"Adventure,Biography,Drama",5.7,8529
24,It,35000000,327481748,697457969,1024939717,989939717,en,13.966,2017-09-08,7.2,10931,2017,135.0,"Horror,Thriller",7.4,359123
29,True Grit,35000000,171243005,252276928,423519933,388519933,en,13.118,2010-12-22,7.2,2816,2010,110.0,"Adventure,Drama,Western",7.6,284034
32,Identity Thief,35000000,134506920,175361578,309868498,274868498,en,13.553,2013-02-09,5.8,2230,2013,111.0,"Adventure,Comedy,Crime",5.7,115624
34,Horrible Bosses,35000000,117538559,212417601,329956160,294956160,en,14.058,2011-07-08,6.5,3842,2011,98.0,"Comedy,Crime",6.9,398695
36,Trainwreck,35000000,110212700,141123897,251336597,216336597,en,18.423,2015-07-17,5.8,1731,2015,125.0,"Comedy,Drama,Romance",6.2,121860
37,Saving Mr. Banks,35000000,83299761,114962525,198262286,163262286,en,9.585,2013-12-20,7.4,2050,2013,125.0,"Biography,Comedy,Drama",7.5,140678
49,A Nightmare on Elm Street,35000000,63075011,117729621,180804632,145804632,en,9.795,2010-04-30,5.5,1408,2010,95.0,"Crime,Drama,Horror",5.2,85497
53,Secretariat,35000000,59699513,60376247,120075760,85075760,en,9.059,2010-10-08,7.0,200,2010,123.0,"Biography,Drama,Family",7.2,24536
55,Friends with Benefits,35000000,55802754,146595891,202398645,167398645,en,14.019,2011-07-21,6.6,4637,2011,109.0,"Comedy,Romance",6.6,317338
56,Neighbors 2: Sorority Rising,35000000,55340730,108757621,164098351,129098351,en,17.662,2016-05-20,5.7,2829,2016,92.0,Comedy,5.7,102793
59,Sicario: Day of the Soldado,35000000,50065850,75885196,125951046,90951046,en,29.725,2018-06-29,6.7,1317,2018,122.0,"Action,Crime,Drama",7.1,95650
62,Poltergeist,35000000,47425125,95713069,143138194,108138194,en,17.343,2015-05-22,5.1,1438,2015,93.0,"Horror,Thriller",4.9,51538
63,Goosebumps 2: Haunted Halloween,35000000,46697321,93291478,139988799,104988799,en,20.238,2018-10-12,5.6,428,2018,90.0,"Adventure,Comedy,Family",5.6,11459
64,12 Strong,35000000,45819713,71118378,116938091,81938091,en,13.183,2018-01-19,5.6,1312,2018,130.0,"Action,Drama,History",6.6,50155
72,Something Borrowed,35000000,39046489,65084116,104130605,69130605,en,7.567,2011-05-05,6.1,591,2011,112.0,"Comedy,Drama,Romance",5.9,54314
74,In Time,35000000,37553932,165103952,202657884,167657884,en,18.912,2011-10-28,6.8,6245,2011,109.0,"Action,Crime,Drama",6.7,346077
76,J. Edgar,35000000,37306030,84606030,121912060,86912060,en,8.628,2011-11-09,6.2,1303,2011,137.0,"Biography,Crime,Drama",6.6,115925
78,Mile 22,35000000,36108758,66295121,102403879,67403879,en,21.246,2018-08-17,6.0,920,2018,94.0,"Action,Adventure,Thriller",6.1,47862
79,Hot Pursuit,35000000,34580201,45671512,80251713,45251713,en,9.607,2015-05-08,5.6,1000,2015,87.0,"Action,Comedy,Crime",5.1,44723
80,Concussion,35000000,34531832,50363790,84895622,49895622,en,5.202,2013-04-04,5.5,55,2013,96.0,Drama,5.7,3813
81,The Foreigner,35000000,34393507,140783360,175176867,140176867,en,14.616,2017-10-13,6.7,1086,2017,113.0,"Action,Thriller",7.0,81288
89,Adrift,35000000,31445011,57897191,89342202,54342202,en,0.6,2013-07-01,7.0,1,2012,65.0,Drama,6.0,6
91,Underworld: Blood Wars,35000000,30353973,81209222,111563195,76563195,en,18.976,2017-01-06,5.5,2318,2016,91.0,"Action,Adventure,Fantasy",5.8,62942
96,Abduction,35000000,28087155,86648359,114735514,79735514,en,17.69,2011-09-23,5.8,1791,2011,106.0,"Action,Mystery,Thriller",5.1,72552
100,Alex Cross,35000000,25888412,35426759,61315171,26315171,en,9.962,2012-10-18,5.1,424,2012,101.0,"Action,Crime,Mystery",5.1,30951
4,Heist,35000000,23483357,28906817,52390174,17390174,en,0.6,2010-02-09,5.0,1,2015,93.0,"Action,Crime,Thriller",6.1,24740
6,Whiskey Tango Foxtrot,35000000,23083334,25350747,48434081,13434081,en,8.564,2016-03-04,6.2,596,2016,112.0,"Biography,Comedy,Drama",6.6,46265
8,Hitman: Agent 47,35000000,22467450,82182803,104650253,69650253,en,14.082,2015-08-21,5.6,1764,2015,96.0,"Action,Adventure,Crime",5.7,80510
10,Premium Rush,35000000,20275446,31393201,51668647,16668647,en,12.484,2012-08-24,6.2,1244,2012,91.0,"Action,Crime,Thriller",6.5,105279
11,Broken City,35000000,19701164,34480045,54181209,19181209,en,13.646,2013-01-18,5.9,814,2013,109.0,"Crime,Drama,Thriller",6.2,71704
14,Cursed,35000000,19294901,25114901,44409802,9409802,en,0.63,2015-04-11,7.0,1,2017,112.0,"Drama,War",6.2,376
17,Furry Vengeance,35000000,17630465,39340177,56970642,21970642,en,9.45,2010-04-02,4.6,283,2010,92.0,"Comedy,Family",3.8,14700
18,Parker,35000000,17616641,48543388,66160029,31160029,en,14.95,2013-01-25,5.8,1868,2013,118.0,"Action,Crime,Thriller",6.2,105529
20,Bait,35000000,15325127,15471969,30797096,-4202904,en,7.117,2012-09-14,5.5,358,2012,93.0,"Action,Adventure,Drama",5.2,14627
24,The Tree of Life,35000000,13305665,61721826,75027491,40027491,en,11.569,2011-05-27,6.6,1730,2011,139.0,"Drama,Fantasy",6.8,156266
26,Zoom,35000000,11989328,12506188,24495516,-10504484,en,3.434,2016-09-02,5.5,43,2015,96.0,"Animation,Comedy,Drama",6.1,2323
29,Sabotage,35000000,10508518,18376443,28884961,-6115039,en,14.055,2014-03-28,5.5,779,2014,109.0,"Action,Crime,Drama",5.7,55597
32,Unfinished Business,35000000,10219501,13214051,23433552,-11566448,en,8.516,2015-03-06,5.2,472,2015,91.0,"Comedy,Drama",5.4,29004
33,The Walk,35000000,10161183,61492104,71653287,36653287,en,11.754,2015-10-02,6.9,1906,2015,89.0,"Crime,Thriller",6.8,126
35,Mandela: Long Walk to Freedom,35000000,8323085,29890402,38213487,3213487,en,8.262,2013-12-25,6.9,319,2013,141.0,"Biography,Drama,History",7.1,25027
40,The Snowman,35000000,6670765,43226146,49896911,14896911,en,14.581,2017-10-20,5.1,1225,2017,119.0,"Crime,Drama,Mystery",5.1,47890
44,Biutiful,35000000,5101237,24687524,29788761,-5211239,es,7.697,2010-12-28,7.2,546,2010,148.0,"Drama,Romance",7.5,80382
47,A Hologram for the King,35000000,4212494,11846010,16058504,-18941496,en,11.055,2016-04-22,5.9,589,2016,98.0,"Comedy,Drama,Romance",6.1,36062
49,Playing for Keeps,35000000,2000000,2000000,4000000,-31000000,en,7.778,2012-12-07,5.6,420,2012,105.0,"Comedy,Romance,Sport",5.7,27389
53,Stolen,35000000,289773,17967746,18257519,-16742481,en,9.813,2012-09-14,5.3,559,2012,96.0,"Action,Crime,Thriller",5.5,41313
54,Trespass,35000000,16816,786532,803348,-34196652,en,11.909,2011-10-14,5.5,589,2011,91.0,"Crime,Drama,Thriller",5.3,39404
56,The Lovers,35000000,0,53899,53899,-34946101,en,5.232,2015-02-13,4.7,47,2013,109.0,"Action,Adventure,Romance",4.6,2867
58,The Darkest Hour,34800000,21443494,62831715,84275209,49475209,en,10.73,2011-12-25,4.9,735,2011,89.0,"Action,Adventure,Horror",4.9,55071
59,Baby Driver,34000000,107825862,228104185,335930047,301930047,en,22.895,2017-06-28,7.4,8034,2017,113.0,"Action,Crime,Drama",7.6,363977
60,The Maze Runner,34000000,102427862,348319861,450747723,416747723,en,36.955,2014-09-19,7.1,10626,2014,113.0,"Action,Mystery,Sci-Fi",6.8,387038
61,The Longest Ride,34000000,37446117,63802928,101249045,67249045,en,11.168,2015-04-10,7.5,1908,2015,123.0,"Drama,Romance",7.1,70327
64,The Darkest Minds,34000000,12695691,38361428,51057119,17057119,en,23.967,2018-08-03,6.8,1158,2018,104.0,"Action,Adventure,Drama",5.7,21340
68,Thunder and the House of Magic,34000000,4091,62582520,62586611,28586611,en,6.781,2014-07-25,6.3,196,2013,85.0,"Adventure,Animation,Comedy",6.3,5626
73,Mike and Dave Need Wedding Dates,33000000,46009673,75898100,121907773,88907773,en,11.676,2016-07-08,6.0,1552,2016,98.0,"Adventure,Comedy,Romance",6.0,74849
74,Step Up Revolution,33000000,35074677,165552290,200626967,167626967,en,10.925,2012-07-27,6.8,1252,2012,99.0,"Drama,Music,Romance",6.5,51295
77,The Watcher,33000000,28946615,47267829,76214444,43214444,en,2.237,2016-10-01,5.4,58,2014,45.0,Drama,7.8,8
78,Safe,33000000,17142080,41495213,58637293,25637293,en,15.622,2012-04-16,6.3,1248,2012,94.0,"Action,Crime,Thriller",6.5,96388
82,The Young and Prodigious T.S. Spivet,33000000,176847,357687,534534,-32465466,en,7.285,2014-10-26,6.7,389,2013,105.0,"Action,Adventure,Comedy",7.1,15372
83,Freaks of Nature,33000000,70958,70958,141916,-32858084,en,9.31,2015-10-30,5.8,231,2015,92.0,"Comedy,Horror,Sci-Fi",5.9,9670
85,Bridesmaids,32500000,169211718,289632023,458843741,426343741,en,9.805,2011-05-13,6.5,2783,2011,125.0,"Comedy,Romance",6.8,249501
87,The Big Wedding,32500000,21819348,48425971,70245319,37745319,en,11.231,2013-04-25,5.8,678,2013,89.0,"Comedy,Drama,Romance",5.6,44221
88,Wanderlust,32500000,17288155,24159934,41448089,8948089,en,9.896,2012-02-24,5.4,693,2012,98.0,"Comedy,Romance",5.6,69081
95,Takers,32000000,57744720,70587268,128331988,96331988,en,8.969,2010-08-26,6.2,605,2010,107.0,"Action,Crime,Thriller",6.2,53377
96,Source Code,32000000,54712227,140428499,195140726,163140726,en,13.495,2011-04-01,7.2,4529,2011,93.0,"Action,Drama,Sci-Fi",7.5,452036
99,I Feel Pretty,32000000,48795601,91553797,140349398,108349398,en,16.298,2018-04-20,6.4,1088,2018,110.0,"Comedy,Romance",5.4,39936
1,"Big Mommas: Like Father, Like Son",32000000,37915414,82332450,120247864,88247864,en,16.024,2011-02-18,5.5,623,2011,107.0,"Action,Comedy,Crime",4.4,23520
7,The Incredible Burt Wonderstone,32000000,22537881,27392609,49930490,17930490,en,9.362,2013-03-15,5.4,920,2013,100.0,"Adventure,Comedy,Fantasy",5.9,67549
10,Bad Times at the El Royale,32000000,17839115,29204379,47043494,15043494,en,31.32,2018-10-12,6.8,1365,2018,141.0,"Crime,Drama,Mystery",7.1,86318
11,Going the Distance,32000000,17804299,43603990,61408289,29408289,en,8.281,2010-09-03,6.0,394,2010,102.0,"Comedy,Romance",6.3,54421
13,Repo Men,32000000,13942007,18195238,32137245,137245,en,12.437,2010-03-19,6.2,976,2010,111.0,"Action,Crime,Sci-Fi",6.3,96144
21,Criminal,31500000,14708696,38771262,53479958,21979958,en,13.651,2016-04-15,5.9,897,2016,113.0,"Action,Crime,Drama",6.3,51666
22,42,31000000,95020213,97470701,192490914,161490914,en,11.28,2013-04-12,7.0,1028,2013,128.0,"Biography,Drama,Sport",7.5,77703
23,Flight,31000000,93772375,160558438,254330813,223330813,en,11.692,2012-11-02,6.7,3582,2012,138.0,"Drama,Thriller",7.3,303009
27,The Grand Budapest Hotel,31000000,59076019,163981261,223057280,192057280,en,18.31,2014-03-07,8.0,8091,2014,99.0,"Adventure,Comedy,Crime",8.1,633604
28,Vacation,31000000,58884188,102306500,161190688,130190688,hu,0.6,2011-04-10,7.0,1,2015,99.0,"Adventure,Comedy",6.1,87582
31,Frequency,31000000,44983704,68079671,113063375,82063375,en,8.833,2000-04-28,7.1,791,2012,60.0,"Sci-Fi,Thriller",5.9,16
33,Extraordinary Measures,31000000,12482741,15826984,28309725,-2690275,en,6.3,2010-01-21,6.3,153,2010,106.0,Drama,6.5,15673
34,Birth of the Dragon,31000000,6901965,7220490,14122455,-16877545,en,8.164,2017-08-25,5.7,172,2016,95.0,"Action,Biography,Drama",5.4,6090
38,Crazy Rich Asians,30000000,174532921,238099711,412632632,382632632,en,17.969,2018-08-15,7.1,1496,2018,120.0,"Comedy,Romance",7.0,96617
42,The Vow,30000000,125014030,197618160,322632190,292632190,en,13.046,2012-02-10,7.1,2409,2012,104.0,"Drama,Romance",6.8,173629
57,Sisters,30000000,87044645,106030660,193075305,163075305,en,10.993,2015-12-18,5.9,922,2015,118.0,Comedy,6.0,58994
69,Looper,30000000,66486205,170466405,236952610,206952610,en,16.779,2012-09-28,6.8,6723,2012,113.0,"Action,Crime,Drama",7.4,500595
70,Warm Bodies,30000000,66380662,115121608,181502270,151502270,en,13.259,2013-02-01,6.3,4109,2013,98.0,"Comedy,Horror,Romance",6.9,208709
72,The Nut Job,30000000,64251538,122529966,186781504,156781504,en,10.501,2014-01-17,5.6,529,2014,85.0,"Adventure,Animation,Comedy",5.7,24587
75,Hope Springs,30000000,63536011,133085295,196621306,166621306,en,8.313,2012-08-07,6.1,429,2012,100.0,"Comedy,Drama,Romance",6.3,38667
83,Midnight in Paris,30000000,56816662,162502774,219319436,189319436,en,13.171,2011-05-20,7.5,3965,2011,94.0,"Comedy,Fantasy,Romance",7.7,356500
84,Darkest Hour,30000000,56443120,150807172,207250292,177250292,en,15.331,2017-11-22,7.3,2715,2017,125.0,"Biography,Drama,History",7.4,136546
88,Life of the Party,30000000,53059911,65759911,118819822,88819822,en,13.696,2018-05-11,6.2,435,2017,84.0,"Comedy,Drama",7.6,47
89,Letters to Juliet,30000000,53032453,82148538,135180991,105180991,en,9.394,2010-05-14,6.9,1706,2010,105.0,"Adventure,Comedy,Drama",6.6,86137
92,Southpaw,30000000,52421953,94156456,146578409,116578409,en,25.305,2015-07-24,7.4,3424,2015,124.0,"Drama,Sport",7.4,199783
94,Atomic Blonde,30000000,51573925,98345423,149919348,119919348,en,21.662,2017-07-28,6.3,3645,2017,115.0,"Action,Mystery,Thriller",6.7,150407
100,Sicario,30000000,46889293,84393749,131283042,101283042,en,20.468,2015-09-18,7.3,4475,2015,121.0,"Action,Crime,Drama",7.6,328548
3,Den of Thieves,30000000,44947622,80131391,125079013,95079013,en,22.738,2018-01-19,6.6,1244,2018,140.0,"Action,Crime,Drama",7.0,69648
4,The Three Stooges,30000000,44338224,54052249,98390473,68390473,en,9.358,2012-04-13,5.1,215,2012,92.0,"Comedy,Family",5.1,28570
6,John Wick,30000000,43037835,76235001,119272836,89272836,en,78.123,2014-10-24,7.2,10081,2014,101.0,"Action,Crime,Thriller",7.4,449942
8,The Age of Adaline,30000000,42629776,68984536,111614312,81614312,en,8.559,2015-04-24,7.4,3853,2015,112.0,"Drama,Fantasy,Romance",7.2,138924
9,Step Up 3D,30000000,42400223,165889117,208289340,178289340,en,17.174,2010-08-06,6.7,1160,2010,107.0,"Drama,Music,Romance",6.2,53081
11,The Cabin in the Woods,30000000,42073277,70689968,112763245,82763245,en,15.336,2012-04-12,6.5,4185,2011,95.0,Horror,7.0,338445
14,Hanna,30000000,40259119,65343694,105602813,75602813,en,9.709,2011-04-08,6.6,1944,2011,111.0,"Action,Drama,Thriller",6.8,179178
22,The Family,30000000,36918811,51078541,87997352,57997352,en,2.0,2011-03-10,3.4,5,2011,88.0,"Horror,Thriller",5.0,833
23,The 15:17 to Paris,30000000,36276286,56096200,92372486,62372486,en,11.576,2018-02-09,5.3,799,2018,94.0,"Biography,Drama,Thriller",5.2,21880
25,Larry Crowne,30000000,35608245,61449135,97057380,67057380,en,7.261,2011-06-30,5.8,676,2011,98.0,"Comedy,Drama,Romance",6.1,58927
26,Carrie,30000000,35266619,82409520,117676139,87676139,en,9.467,1976-11-03,7.1,1766,2013,100.0,"Drama,Horror",5.9,125424
28,Death Wish,30000000,34017028,48575965,82592993,52592993,en,18.014,2018-03-02,5.9,1207,2018,107.0,"Action,Crime,Drama",6.4,50279
30,Entourage,30000000,32363404,46438538,78801942,48801942,en,13.802,2015-06-03,6.2,647,2015,104.0,Comedy,6.6,71519
32,Side Effects,30000000,32172757,66742138,98914895,68914895,en,9.426,2013-02-08,6.5,1879,2013,106.0,"Crime,Drama,Mystery",7.1,168466
34,Deliver Us from Evil,30000000,30577122,87956618,118533740,88533740,en,11.283,2014-07-02,6.1,1104,2014,118.0,"Horror,Mystery,Thriller",6.2,63793
35,Get on Up,30000000,30569935,33339868,63909803,33909803,en,6.288,2014-08-01,6.7,251,2014,139.0,"Biography,Drama,Music",6.9,19024
37,The Five-Year Engagement,30000000,28700285,61623819,90324104,60324104,en,10.729,2012-04-27,5.8,742,2012,124.0,"Comedy,Romance",6.2,88469
39,Winnie the Pooh,30000000,26692846,50145607,76838453,46838453,en,11.147,2011-07-14,6.9,444,2011,63.0,"Adventure,Animation,Comedy",7.2,19605
42,White Boy Rick,30000000,24004833,25947983,49952816,19952816,en,13.794,2018-09-14,6.3,277,2018,111.0,"Crime,Drama",6.4,16255
45,Sanctum,30000000,23209310,108957098,132166408,102166408,en,7.457,2011-02-04,5.9,515,2011,108.0,"Adventure,Drama,Thriller",5.9,51318
47,Ballerina,30000000,21858070,96892829,118750899,88750899,en,13.21,2017-08-25,7.2,1024,2012,50.0,"Biography,Documentary",7.5,13
49,The Next Three Days,30000000,21148651,67255916,88404567,58404567,en,11.147,2010-11-19,7.0,1469,2010,133.0,"Action,Crime,Drama",7.4,168066
50,Proud Mary,30000000,20868638,21709539,42578177,12578177,en,9.371,2018-01-12,5.5,259,2018,89.0,"Action,Crime,Drama",4.9,6805
53,Runner Runner,30000000,19316646,60512680,79829326,49829326,en,10.442,2013-10-02,5.6,761,2013,88.0,"Crime,Thriller",5.6,58235
55,Baahubali 2: The Conclusion,30000000,18985794,263502914,282488708,252488708,te,10.406,2017-04-27,7.0,252,2017,167.0,"Action,Drama",8.3,65656
58,Fright Night,30000000,18298649,40520649,58819298,28819298,en,12.078,2011-08-19,6.0,1024,2011,106.0,"Comedy,Horror",6.4,94555
60,Steve Jobs,30000000,17766658,35579007,53345665,23345665,en,8.895,2015-10-09,6.8,2572,2015,122.0,"Biography,Drama",7.2,138668
74,The Last Stand,30000000,12050299,48330757,60381056,30381056,en,15.894,2013-01-12,5.9,1692,2013,107.0,"Action,Thriller",6.4,126623
78,Dead Man Down,30000000,10895295,19599974,30495269,495269,en,10.349,2013-03-08,6.0,866,2013,118.0,"Action,Crime,Drama",6.5,61238
82,The Lost City of Z,30000000,8574339,17121823,25696162,-4303838,en,11.048,2017-04-21,6.2,1397,2016,141.0,"Adventure,Biography,Drama",6.6,66475
84,The Space Between Us,30000000,7885294,16481405,24366699,-5633301,en,14.437,2017-02-03,7.1,1455,2017,120.0,"Adventure,Drama,Romance",6.4,41031
86,Barney's Version,30000000,7502560,8845575,16348135,-13651865,en,7.357,2011-01-14,7.2,210,2010,134.0,"Comedy,Drama",7.3,23058
87,Trapped,30000000,6916869,6916869,13833738,-16166262,en,0.655,2012-04-01,5.8,2,2012,92.0,"Adventure,Drama,Thriller",5.0,138
88,Kin,30000000,5718096,10096821,15814917,-14185083,en,23.805,2018-08-31,6.2,289,2012,45.0,"Drama,Music",8.6,46
90,Stronger,30000000,4211129,8786752,12997881,-17002119,en,7.836,2017-09-22,7.0,782,2017,119.0,"Biography,Drama",7.0,33464
91,Gloria,30000000,4167493,4967493,9134986,-20865014,es,5.925,2014-01-23,6.5,83,2013,110.0,"Comedy,Drama,Romance",6.8,7640
99,Machine Gun Preacher,30000000,538690,3721988,4260678,-25739322,en,9.12,2011-09-23,6.5,477,2011,129.0,"Action,Biography,Crime",6.8,60074
100,Bilal: A New Breed of Hero,30000000,490973,648599,1139572,-28860428,en,2.707,2018-02-02,6.8,54,2015,105.0,"Action,Adventure,Animation",8.0,16854
5,Wild Card,30000000,3200,4315789,4318989,-25681011,en,0.917,2011-01-01,8.0,1,2015,92.0,"Action,Crime,Drama",5.6,46463
6,United Passions,30000000,918,168832,169750,-29830250,en,1.519,2015-06-05,3.3,21,2014,110.0,"Drama,History,Sport",2.1,3878
8,Grace of Monaco,30000000,0,25199891,25199891,-4800109,en,6.058,2014-06-06,6.0,352,2014,103.0,"Biography,Drama,Romance",5.7,16685
11,Space Pirate Captain Harlock,30000000,0,310985,310985,-29689015,ja,8.623,2014-08-01,6.5,596,2010,100.0,"Animation,Sci-Fi",7.1,324
13,Collide,29200000,2280004,5466698,7746702,-21453298,en,9.035,2017-02-24,5.6,331,2010,,Action,5.5,12
14,Pitch Perfect 2,29000000,184296230,287625468,471921698,442921698,en,18.469,2015-05-15,6.8,3599,2015,115.0,"Comedy,Music",6.4,130692
16,Night School,29000000,77339130,103008792,180347922,151347922,en,0.6,2016-04-15,7.0,2,2016,85.0,Documentary,7.2,112
17,The Boss,29000000,63077560,78652207,141729767,112729767,en,11.442,2016-04-08,5.8,822,2016,99.0,Comedy,5.4,39096
21,Logan Lucky,29000000,27778642,44264271,72042913,43042913,en,15.743,2017-08-18,6.7,1627,2017,118.0,"Comedy,Crime,Drama",7.0,105966
22,Florence Foster Jenkins,29000000,27383770,56000339,83384109,54384109,en,8.453,2016-08-12,6.7,849,2016,111.0,"Biography,Comedy,Drama",6.8,44970
30,Unhinged,29000000,0,0,0,-29000000,en,3.864,2017-08-08,5.1,6,2017,93.0,Horror,4.2,512
35,Straight Outta Compton,28000000,161197785,202182981,363380766,335380766,en,11.731,2015-08-14,7.7,2048,2015,147.0,"Biography,Drama,History",7.9,165307
36,Girls Trip,28000000,115108515,140886353,255994868,227994868,en,8.589,2017-07-21,6.8,968,2017,122.0,"Comedy,Drama",6.2,29321
40,A Bad Moms Christmas,28000000,72110659,127710550,199821209,171821209,en,16.604,2017-11-01,6.3,1044,2017,104.0,"Adventure,Comedy",5.5,33056
41,Safe Haven,28000000,71399120,94050951,165450071,137450071,en,9.095,2013-02-14,7.1,1433,2013,115.0,"Drama,Romance,Thriller",6.7,97055
42,The Big Short,28000000,70259870,133162752,203422622,175422622,en,14.327,2015-12-11,7.3,4657,2015,130.0,"Biography,Comedy,Drama",7.8,309227
44,"Alexander and the Terrible, Horrible, No Good, Very Bad Day",28000000,66954149,101379287,168333436,140333436,en,6.783,2014-10-10,6.2,817,2014,81.0,"Comedy,Family",6.2,37325
46,Last Vegas,28000000,63914167,112914167,176828334,148828334,en,6.533,2013-11-01,6.4,1211,2013,105.0,"Comedy,Drama",6.6,121409
50,Tag,28000000,54730625,77026186,131756811,103756811,en,1.4,2015-05-04,4.0,1,2015,91.0,Drama,4.6,158
52,Identity,28000000,52131264,82183683,134314947,106314947,en,0.6,2012-05-24,6.3,3,2018,93.0,"Crime,Drama",6.6,58
54,Kick-Ass,28000000,48071303,97531134,145602437,117602437,en,13.08,2010-04-16,7.1,7540,2010,117.0,"Action,Comedy",7.6,497363
60,30 Minutes or Less,28000000,37053924,40966716,78020640,50020640,en,11.315,2011-08-12,5.6,825,2011,83.0,"Action,Comedy,Crime",6.1,87254
64,3 Days to Kill,28000000,30697999,38959900,69657899,41657899,en,11.011,2014-02-14,6.1,1279,2014,117.0,"Action,Drama,Thriller",6.2,81681
65,Kick-Ass 2,28000000,28795985,63129909,91925894,63925894,en,14.793,2013-08-16,6.4,3785,2013,103.0,"Action,Comedy,Crime",6.6,238832
67,A Walk Among the Tombstones,28000000,26017685,62108587,88126272,60126272,en,19.373,2014-09-19,6.3,1685,2014,114.0,"Action,Crime,Drama",6.5,105116
68,The Spy Next Door,28000000,24307106,46752858,71059964,43059964,en,10.746,2010-01-15,5.7,650,2010,94.0,"Action,Comedy,Family",5.5,36767
69,Brick Mansions,28000000,20396829,73421224,93818053,65818053,en,9.194,2014-04-25,5.9,909,2014,90.0,"Action,Crime",5.7,37528
72,American Ultra,28000000,14439985,30295028,44735013,16735013,en,9.97,2015-08-21,6.0,1756,2015,96.0,"Action,Comedy,Sci-Fi",6.1,76769
74,Pride and Prejudice and Zombies,28000000,10907291,16638300,27545591,-454409,en,9.086,2016-02-05,5.7,1195,2016,108.0,"Action,Comedy,Horror",5.8,46187
86,Joyful Noise,27500000,30932113,31157914,62090027,34590027,en,6.787,2012-01-13,6.4,70,2012,118.0,"Comedy,Drama,Music",5.8,7575
90,Anonymous,27500000,4463292,15815509,20278801,-7221199,en,8.114,2011-10-28,6.4,434,2011,130.0,"Drama,Thriller",6.9,37932
91,Limitless,27000000,79249455,155564919,234814374,207814374,en,19.453,2011-03-08,7.1,6295,2011,105.0,"Mystery,Sci-Fi,Thriller",7.4,492490
98,Money Monster,27000000,41012075,93466095,134478170,107478170,en,11.134,2016-05-13,6.4,1859,2016,98.0,"Crime,Drama,Thriller",6.5,86607
28,Flatliners,26000000,61308153,61308153,122616306,96616306,en,9.844,2017-09-29,5.7,1249,2017,109.0,"Drama,Horror,Mystery",5.2,33752
30,Red Eye,26000000,57891803,96666486,154558289,128558289,en,0.6,2017-10-01,5.0,2,2017,73.0,Horror,3.3,275
33,Pain & Gain,26000000,49875291,81275291,131150582,105150582,en,16.509,2013-04-26,6.1,2500,2013,129.0,"Action,Comedy,Crime",6.4,187820
37,Legion,26000000,40168080,67647574,107815654,81815654,en,12.032,2010-01-22,5.3,1154,2010,100.0,"Action,Fantasy,Horror",5.2,92709
38,Lawless,26000000,37397291,54393687,91790978,65790978,en,12.147,2012-08-29,7.0,1660,2012,116.0,"Crime,Drama",7.3,214055
41,Brothers,26000000,28544157,45043870,73588027,47588027,en,0.6,2014-01-01,7.3,3,2011,90.0,Drama,5.8,149
42,The Best of Me,26000000,26766213,41059418,67825631,41825631,en,8.622,2014-10-17,7.3,1512,2014,118.0,"Drama,Romance",6.7,59750
45,The Raven,26000000,16008272,30601801,46610073,20610073,en,0.6,2010-04-20,5.9,5,2012,110.0,"Crime,Mystery,Thriller",6.4,79578
50,The Fifth Estate,26000000,3254172,6154172,9408344,-16591656,en,6.611,2013-10-18,5.9,549,2013,128.0,"Biography,Drama,Thriller",6.2,36392
52,Blood Ties,26000000,42472,2923959,2966431,-23033569,en,12.003,2014-03-21,6.1,268,2013,127.0,"Action,Crime,Drama",6.5,17771
55,Accidental Love,26000000,0,135436,135436,-25864564,en,6.487,2015-02-10,4.0,172,2015,100.0,"Comedy,Romance",4.1,7048
56,The Face of an Angel,26000000,0,0,0,-26000000,en,6.495,2015-03-27,5.0,94,2014,101.0,"Crime,Drama",4.6,4211
63,The Help,25000000,169705587,213120004,382825591,357825591,en,12.598,2011-08-10,8.1,3944,2011,146.0,Drama,8.1,392699
64,Hidden Figures,25000000,169607287,231771716,401379003,376379003,en,14.751,2016-12-10,8.0,4710,2016,127.0,"Biography,Drama,History",7.8,171131
67,Ride Along,25000000,134202565,153733800,287936365,262936365,en,10.831,2014-01-17,6.2,1277,2014,99.0,"Action,Comedy,Crime",6.2,94529
77,Dear John,25000000,80014842,142033509,222048351,197048351,en,12.048,2010-02-04,6.8,2676,2010,108.0,"Drama,Romance,War",6.3,128657
79,Parental Guidance,25000000,77267296,120832383,198099679,173099679,en,10.124,2012-12-25,5.8,276,2012,105.0,"Comedy,Family",6.1,23711
84,No Strings Attached,25000000,70662220,149228078,219890298,194890298,en,14.203,2011-01-21,6.2,2612,2011,108.0,"Comedy,Romance",6.2,197663
85,Contraband,25000000,66528000,98406855,164934855,139934855,en,12.357,2012-01-13,6.2,1114,2012,109.0,"Action,Crime,Drama",6.5,111709
87,The Lucky One,25000000,60457138,96633833,157090971,132090971,en,13.14,2012-04-20,6.9,2012,2012,101.0,"Drama,Romance",6.5,94359
92,Madea's Big Happy Family,25000000,53345287,54160818,107506105,82506105,en,9.393,2011-04-22,6.7,71,2011,106.0,"Comedy,Drama",4.7,6996
95,The Grey,25000000,51580136,81249176,132829312,107829312,en,12.942,2012-01-27,6.5,2280,2011,117.0,"Action,Adventure,Drama",6.8,228798
96,Hide and Seek,25000000,51100486,123696741,174797227,149797227,en,0.631,2013-08-19,8.0,1,2013,107.0,"Action,Horror,Mystery",6.4,1287
2,The Giver,25000000,45090374,66540205,111630579,86630579,en,8.687,2014-08-11,6.5,3075,2014,97.0,"Drama,Romance,Sci-Fi",6.5,104999
6,The Night Before,25000000,43035725,52427346,95463071,70463071,en,9.014,2015-11-20,6.1,956,2015,101.0,"Adventure,Comedy,Fantasy",6.4,58455
15,August: Osage County,25000000,37738810,50738810,88477620,63477620,en,9.586,2013-12-27,6.9,843,2013,121.0,"Comedy,Drama",7.2,79383
17,Million Dollar Arm,25000000,36447959,39217912,75665871,50665871,en,7.771,2014-05-16,6.8,353,2014,124.0,"Biography,Drama,Sport",7.0,41008
21,Peppermint,25000000,35418723,51800758,87219481,62219481,en,32.476,2018-09-07,6.5,716,2018,101.0,"Action,Crime,Drama",6.5,35854
25,The Gambler,25000000,33680992,38718031,72399023,47399023,en,8.807,2014-12-25,5.8,783,2015,105.0,Drama,7.0,10
29,Fist Fight,25000000,32187017,40286416,72473433,47473433,en,9.808,2017-02-17,6.0,708,2017,91.0,Comedy,5.6,35136
32,The Sitter,25000000,30542576,38749404,69291980,44291980,en,11.571,2011-12-09,5.4,472,2011,81.0,Comedy,5.7,65575
36,Draft Day,25000000,28842237,29847480,58689717,33689717,en,10.581,2014-04-11,6.6,460,2014,110.0,"Drama,Sport",6.8,48812
38,Rings,25000000,27793018,82917283,110710301,85710301,en,13.53,2017-02-03,4.9,1785,2017,102.0,"Drama,Horror,Mystery",4.5,34151
43,Don't Be Afraid of the Dark,25000000,24046682,39126427,63173109,38173109,en,8.405,2010-11-06,5.5,550,2010,99.0,"Fantasy,Horror,Thriller",5.6,44490
44,The Losers,25000000,23591432,29863840,53455272,28455272,en,10.202,2010-04-23,6.2,844,2010,97.0,"Action,Adventure,Crime",6.4,83876
46,War,25000000,22486409,40686409,63172818,38172818,en,0.6,2017-02-26,6.0,1,2014,106.0,Drama,6.8,204
50,The Eagle,25000000,19490041,38993548,58483589,33483589,en,8.443,2011-02-11,6.1,694,2011,114.0,"Action,Adventure,Drama",6.2,61475
52,Shark Night 3D,25000000,18877153,18877153,37754306,12754306,en,7.879,2011-09-02,5.0,245,2011,90.0,"Horror,Thriller",4.0,23190
56,Father Figures,25000000,17501244,21038441,38539685,13539685,en,12.45,2017-12-22,5.8,277,2017,113.0,"Adventure,Comedy,Drama",5.5,14373
58,The Counselor,25000000,16973715,71009334,87983049,62983049,en,10.55,2013-10-25,5.1,1072,2013,117.0,"Crime,Drama,Thriller",5.3,92096
60,Mary Queen of Scots,25000000,16468499,46734733,63203232,38203232,en,16.115,2018-12-07,6.6,592,2013,119.0,"Biography,Drama,History",5.5,753
63,Legend,25000000,15502112,23506237,39008349,14008349,en,10.542,1986-04-18,6.2,509,2014,168.0,"Action,Drama",6.5,1568
66,The Box,25000000,15051977,34356760,49408737,24408737,en,0.84,2018-03-04,8.0,1,2011,89.0,Drama,6.3,51
68,My Soul to Take,25000000,14744435,16727470,31471905,6471905,en,9.808,2010-10-08,5.4,247,2010,107.0,"Horror,Mystery,Thriller",4.8,18381
74,Warrior,25000000,13657115,24215385,37872500,12872500,en,15.478,2011-09-09,7.8,2189,2011,140.0,"Drama,Sport",8.2,403755
76,Battle of the Sexes,25000000,12638526,18445379,31083905,6083905,ru,0.6,2015-12-03,5.5,4,2017,121.0,"Biography,Comedy,Drama",6.7,43245
77,Cirque du Soleil: Worlds Away,25000000,12512862,28012862,40525724,15525724,en,6.538,2012-12-21,6.8,82,2012,91.0,Fantasy,6.8,7643
78,The 33,25000000,12227722,28400715,40628437,15628437,en,9.993,2015-11-09,6.2,565,2015,127.0,"Biography,Drama,History",6.9,32263
80,The Conspirator,25000000,11538204,15907411,27445615,2445615,en,6.493,2011-04-15,6.5,226,2010,122.0,"Crime,Drama,History",6.9,26416
88,Straw Dogs,25000000,10324441,11253821,21578262,-3421738,en,8.749,2011-09-16,5.7,255,2011,110.0,"Action,Drama,Thriller",5.8,30924
94,The Road,25000000,8114270,29206732,37321002,12321002,tl,2.948,2012-05-11,5.1,24,2011,110.0,"Crime,Drama,Horror",5.6,1617
95,Beautiful Boy,25000000,7634767,13031424,20666191,-4333809,en,5.872,2011-06-03,6.0,47,2018,120.0,"Biography,Drama",7.3,30368
6,Sgt. Stubby: An American Hero,25000000,3054285,3645957,6700242,-18299758,en,6.107,2018-04-13,6.4,9,2018,84.0,"Adventure,Animation,Family",6.9,1225
7,Carnage,25000000,2546747,38112154,40658901,15658901,en,10.181,2011-12-16,7.1,1478,2011,80.0,"Comedy,Drama",7.2,111372
8,Tulip Fever,25000000,2455635,6792768,9248403,-15751597,en,9.89,2017-08-25,6.4,307,2017,105.0,"Drama,History,Romance",6.2,15037
12,Jane Got a Gun,25000000,1513793,3771345,5285138,-19714862,en,8.825,2016-01-29,5.5,439,2015,98.0,"Action,Drama,Western",5.9,19051
17,On the Road,25000000,720828,9313302,10034130,-14965870,en,8.919,2012-12-21,5.6,518,2012,124.0,"Adventure,Drama,Romance",6.1,37886
19,Love Ranch,25000000,137885,146149,284034,-24715966,en,6.185,2010-06-30,6.1,28,2010,117.0,"Biography,Comedy,Drama",5.6,2742
25,Ironclad,25000000,0,5297411,5297411,-19702589,en,10.202,2011-07-08,6.1,373,2011,121.0,"Action,Adventure,Drama",6.2,38477
27,Red Sky,25000000,0,91116,91116,-24908884,en,3.879,2014-03-12,4.5,33,2011,,"Drama,Romance",4.8,246
29,The Adventurer: The Curse of the Midas Box,25000000,0,0,0,-25000000,en,8.417,2013-12-05,5.1,108,2013,100.0,"Adventure,Family,Fantasy",5.4,5257
30,Reagan,25000000,0,0,0,-25000000,en,1.58,2011-02-07,4.8,9,2011,105.0,"Biography,Documentary",7.4,732
31,Dangerous Liaisons,24200000,17000,10447579,10464579,-13735421,zh,3.035,2012-11-09,6.2,22,2012,110.0,"Drama,Mystery,Romance",5.9,1694
36,Think Like a Man Too,24000000,65028687,70027933,135056620,111056620,en,8.25,2014-06-20,6.3,319,2014,106.0,"Comedy,Romance",5.8,18533
37,Fences,24000000,57682904,64282881,121965785,97965785,en,12.753,2016-12-16,6.8,1465,2016,139.0,Drama,7.2,86749
39,Footloose,24000000,51802742,62989834,114792576,90792576,en,10.269,2011-10-14,6.6,929,2011,113.0,"Comedy,Drama,Music",5.9,43251
40,Going in Style,24000000,45018541,78672579,123691120,99691120,en,11.25,2017-04-07,6.6,1324,2017,96.0,"Comedy,Crime",6.6,66418
52,Piranha 3D,24000000,25003155,83660160,108663315,84663315,en,11.302,2010-08-20,5.3,1029,2010,88.0,"Comedy,Horror",5.4,81327
53,Faster,24000000,23240020,35792945,59032965,35032965,en,14.172,2010-11-23,6.2,895,2010,98.0,"Action,Crime,Drama",6.5,93618
58,I Don't Know How She Does It,24000000,9659074,24474463,34133537,10133537,en,8.271,2011-09-16,5.2,231,2011,89.0,"Comedy,Romance",4.9,18552
60,Dhoom 3,24000000,8031955,11723620,19755575,-4244425,hi,6.798,2013-12-20,5.9,136,2013,172.0,"Action,Thriller",5.4,40466
71,Green Book,23000000,85080171,322034439,407114610,384114610,en,36.284,2018-11-16,8.3,3499,2018,130.0,"Biography,Comedy,Drama",8.3,204972
73,The Wedding Ringer,23000000,64460211,80171596,144631807,121631807,en,15.876,2015-01-16,6.5,961,2015,101.0,Comedy,6.7,66893
76,The Ides of March,23000000,40962534,77735925,118698459,95698459,en,10.127,2011-10-07,6.7,1405,2011,101.0,"Drama,Thriller",7.1,207417
78,The Hate U Give,23000000,29719483,35067665,64787148,41787148,en,19.135,2018-10-19,8.2,636,2018,133.0,"Crime,Drama",7.3,17583
80,Her,23000000,25568251,48163815,73732066,50732066,en,15.968,2013-12-18,7.9,7776,2013,126.0,"Drama,Romance,Sci-Fi",8.0,467232
83,Haywire,23000000,18942396,36374700,55317096,32317096,en,10.015,2011-11-06,5.6,747,2011,93.0,"Action,Drama,Thriller",5.8,78681
86,Eddie the Eagle,23000000,15789389,45060480,60849869,37849869,en,11.483,2016-02-26,7.2,1190,2015,106.0,"Biography,Comedy,Drama",7.4,75331
88,The Crew,23000000,13019253,13019253,26038506,3038506,fr,8.826,2016-09-24,6.2,134,2015,81.0,"Crime,Drama,Thriller",6.3,3030
97,Redemption,23000000,36686,13593473,13630159,-9369841,fr,0.666,2012-05-02,3.8,2,2011,97.0,"Adventure,Drama,Romance",4.5,98
3,Nocturnal Animals,22500000,10663357,32398681,43062038,20562038,en,16.19,2016-11-18,7.4,4192,2016,116.0,"Drama,Thriller",7.5,205240
4,The Water Diviner,22500000,4200117,31054727,35254844,12754844,en,11.479,2015-04-24,6.8,682,2014,111.0,"Drama,History,War",7.1,66595
5,Ghost,22000000,217631306,517600000,735231306,713231306,ru,2.832,2015-04-20,5.7,23,2010,115.0,"Drama,Fantasy,Mystery",5.8,229
11,Son of God,22000000,59700064,70949793,130649857,108649857,en,8.289,2014-02-28,6.4,123,2010,80.0,Documentary,6.8,13
13,The Hundred-Foot Journey,22000000,54235441,94270488,148505929,126505929,en,8.26,2014-08-08,7.3,785,2014,122.0,"Comedy,Drama",7.3,69562
17,Diary of a Wimpy Kid: Dog Days,22000000,49008662,77229695,126238357,104238357,en,11.36,2012-08-03,6.2,440,2012,94.0,"Comedy,Family",6.3,19571
19,Derailed,22000000,36020063,57520063,93540126,71540126,en,7.814,2005-11-11,6.2,500,2016,107.0,"Action,Crime",6.3,212
21,Delivery Man,22000000,30659817,70536870,101196687,79196687,en,7.962,2013-11-22,6.2,858,2013,105.0,"Comedy,Drama",6.4,70706
22,"Hail, Caesar!",22000000,30080225,64160680,94240905,72240905,en,12.312,2016-02-05,5.9,2328,2016,106.0,"Comedy,Drama,Music",6.3,111422
27,Diary of a Wimpy Kid: The Long Haul,22000000,20738724,35609577,56348301,34348301,en,10.839,2017-05-19,5.6,193,2017,91.0,"Comedy,Family",4.4,5635
29,Homefront,22000000,20158492,51695362,71853854,49853854,en,14.422,2013-11-27,6.5,1410,2013,100.0,"Action,Thriller",6.5,98549
34,The Transporter Refueled,22000000,16029670,69698495,85728165,63728165,en,13.428,2015-09-04,5.4,836,2015,96.0,"Action,Adventure,Crime",5.2,36201
37,Hit & Run,22000000,13749300,17216955,30966255,8966255,en,7.48,2012-08-22,5.7,312,2019,114.0,"Action,Comedy",7.1,43
40,"Roman J. Israel, Esq.",22000000,11962712,12967012,24929724,2929724,en,12.688,2017-11-17,6.2,499,2017,122.0,"Crime,Drama,Thriller",6.4,23632
41,Out of the Furnace,22000000,11330849,15434375,26765224,4765224,en,9.139,2013-12-06,6.6,1077,2013,116.0,"Crime,Drama,Thriller",6.8,99037
44,Just Getting Started,22000000,6069605,6756412,12826017,-9173983,en,8.459,2017-12-08,4.9,94,2017,91.0,"Action,Comedy",4.4,4829
49,Before I Go to Sleep,22000000,3242457,19563579,22806036,806036,en,16.07,2014-10-31,6.4,1098,2014,92.0,"Drama,Horror,Mystery",6.3,64684
50,Stone,22000000,1810078,4065020,5875098,-16124902,en,8.401,2010-10-22,5.2,334,2010,105.0,"Drama,Thriller",5.4,38667
58,To Rome with Love,21500000,16684352,74326015,91010367,69510367,en,9.563,2012-06-22,5.7,1097,2012,112.0,"Comedy,Music,Romance",6.3,79381
59,Silver Linings Playbook,21000000,132092958,236412453,368505411,347505411,en,15.351,2012-12-25,7.1,7636,2012,122.0,"Comedy,Drama,Romance",7.7,621018
60,Blockers,21000000,60311495,94045328,154356823,133356823,en,21.841,2018-04-06,6.1,969,2018,102.0,Comedy,6.2,57142
64,Death at a Funeral,21000000,42739347,48977233,91716580,70716580,en,6.862,2010-04-15,5.7,439,2010,92.0,Comedy,5.7,42042
67,For Colored Girls,21000000,37729698,38017873,75747571,54747571,en,2.858,2010-11-05,6.8,33,2010,133.0,Drama,6.1,6728
69,Kidnap,21000000,30718107,34836080,65554187,44554187,en,10.959,2017-08-04,6.0,805,2019,,Drama,7.5,26
72,Tinker Tailor Soldier Spy,21000000,24149393,81452811,105602204,84602204,en,10.831,2011-12-09,6.7,1402,2011,122.0,"Drama,Mystery,Thriller",7.1,174890
79,The Beaver,21000000,970816,5046038,6016854,-14983146,en,7.357,2011-05-05,6.3,464,2011,91.0,Drama,6.7,45173
80,Bitter Harvest,21000000,557241,606162,1163403,-19836597,en,5.489,2017-02-24,6.2,42,2017,103.0,"Drama,Romance,War",6.1,3057
81,Molly,21000000,17396,17396,34792,-20965208,en,1.4,2018-09-25,5.8,5,2017,91.0,"Action,Sci-Fi",4.6,726
92,La La Land,20000000,151101803,426351163,577452966,557452966,en,16.275,2016-12-09,7.9,10028,2016,128.0,"Comedy,Drama,Music",8.0,436070
93,The Conjuring,20000000,137400141,318000141,455400282,435400282,en,18.886,2013-07-19,7.5,5912,2013,112.0,"Horror,Mystery,Thriller",7.5,397233
95,Wonder,20000000,132422809,304604712,437027521,417027521,en,20.101,2017-11-17,8.2,3959,2017,113.0,"Drama,Family",8.0,111632
98,Jackass 3D,20000000,117229692,171685793,288915485,268915485,en,10.715,2010-10-15,6.3,655,2010,95.0,"Action,Comedy,Documentary",7.0,53289
99,Bad Moms,20000000,113257297,180998716,294256013,274256013,en,14.332,2016-07-29,6.5,2600,2016,100.0,Comedy,6.2,100952
3,Tammy,20000000,84525432,96407655,180933087,160933087,en,10.979,2014-07-03,5.2,735,2014,97.0,"Comedy,Romance",4.9,44345
5,The Descendants,20000000,82624961,175507800,258132761,238132761,en,10.444,2011-11-18,6.8,1522,2011,115.0,"Comedy,Drama",7.3,223464
15,The Last Song,20000000,62950384,92678948,155629332,135629332,en,9.237,2010-03-31,7.2,2199,2010,107.0,"Drama,Music,Romance",6.0,74914
16,Why Did I Get Married Too?,20000000,60095852,60831067,120926919,100926919,en,6.636,2010-04-02,5.9,49,2010,121.0,"Comedy,Drama,Romance",4.6,8653
18,12 Years a Slave,20000000,56671993,181025343,237697336,217697336,en,16.493,2013-10-30,7.9,6631,2013,134.0,"Biography,Drama,History",8.1,577301
20,Me Before You,20000000,56245075,208265198,264510273,244510273,en,16.917,2016-06-03,7.7,5939,2016,106.0,"Drama,Romance",7.4,174567
22,Barbershop: The Next Cut,20000000,54030051,54404202,108434253,88434253,en,12.846,2016-04-15,6.0,248,2016,111.0,"Comedy,Drama",5.9,13306
24,A Simple Favor,20000000,53548586,97628717,151177303,131177303,en,21.121,2018-09-14,6.6,1756,2018,117.0,"Comedy,Crime,Drama",6.9,83338
25,Selma,20000000,52076908,66776576,118853484,98853484,en,9.541,2014-12-25,7.5,1354,2014,128.0,"Biography,Drama,History",7.5,77633
34,Spotlight,20000000,45055776,92088460,137144236,117144236,en,16.354,2015-11-06,7.8,4935,2015,129.0,"Crime,Drama",8.1,365110
35,Acrimony,20000000,43549096,46627836,90176932,70176932,en,10.6,2018-03-30,6.6,186,2018,120.0,"Drama,Romance,Thriller",5.7,6119
36,Max,20000000,42656255,43658157,86314412,66314412,en,7.766,2015-06-26,6.8,407,2012,83.0,Comedy,5.1,248
39,The Star,20000000,40847995,62758010,103606005,83606005,en,14.53,2017-11-17,5.4,233,2017,86.0,"Adventure,Animation,Comedy",6.1,5159
43,Nerve,20000000,38583626,70652284,109235910,89235910,en,0.6,2011-12-07,10.0,1,2011,83.0,"Comedy,Drama",6.8,88
48,Risen,20000000,36880033,46255763,83135796,63135796,en,10.089,2016-02-18,5.8,433,2010,121.0,"Biography,Drama",5.3,182
49,Vampires Suck,20000000,36661504,81424988,118086492,98086492,en,8.992,2010-08-18,4.1,658,2010,82.0,Comedy,3.4,43984
50,The Black Hole,20000000,35841901,35841901,71683802,51683802,en,2.075,2015-05-26,2.9,14,2016,111.0,"Sci-Fi,Thriller",2.8,346
51,The American,20000000,35606376,67950723,103557099,83557099,en,9.042,2010-09-01,5.8,690,2010,105.0,"Crime,Drama,Thriller",6.3,86863
55,Texas Chainsaw 3D,20000000,34341945,47666013,82007958,62007958,en,18.256,2013-01-04,5.3,780,2013,92.0,"Horror,Thriller",4.8,41784
60,Copycat,20000000,32051917,32051917,64103834,44103834,en,0.6,2015-03-06,6.7,3,2016,90.0,Comedy,5.1,157
62,She's Out of My League,20000000,32010860,48680977,80691837,60691837,en,7.775,2010-03-12,6.1,970,2010,104.0,"Comedy,Romance",6.4,117245
63,Milk,20000000,31841299,57293371,89134670,69134670,en,1.4,2015-09-25,5.0,1,2015,91.0,"Documentary,Family",7.2,14
65,The Debt,20000000,31177548,46604054,77781602,57781602,en,12.697,2011-08-31,6.6,403,2010,113.0,"Drama,Thriller",6.9,61046
76,The World's End,20000000,26004851,47508505,73513356,53513356,en,12.719,2013-08-23,6.7,2990,2013,109.0,"Action,Comedy,Sci-Fi",7.0,235308
78,You Again,20000000,25702053,32838945,58540998,38540998,en,10.208,2010-09-24,6.2,734,2010,105.0,"Comedy,Family,Romance",5.8,46690
81,On the Basis of Sex,20000000,24622687,38073377,62696064,42696064,en,32.624,2018-12-25,7.4,225,2018,120.0,"Biography,Drama",6.9,12083
82,Endless Love,20000000,23438250,34718173,58156423,38156423,en,8.776,2014-02-14,6.8,990,2014,104.0,"Drama,Romance",6.3,37869
83,The Covenant,20000000,23364784,38164784,61529568,41529568,en,2.733,2017-02-07,4.4,14,2013,99.0,Musical,6.2,5
84,Monte Carlo,20000000,23186769,39686769,62873538,42873538,en,11.017,2011-07-01,6.2,1193,2011,109.0,"Adventure,Comedy,Family",5.8,38731
87,Rough Night,20000000,22105643,46844357,68950000,48950000,en,14.338,2017-06-16,5.6,1096,2017,101.0,"Comedy,Crime,Thriller",5.2,39447
92,Vampires,20000000,20268825,20268825,40537650,20537650,en,0.6,2010-08-08,6.0,1,2010,88.0,"Comedy,Fantasy,Horror",6.2,851
94,Secret in Their Eyes,20000000,20180155,32608019,52788174,32788174,en,6.892,2015-11-20,6.3,696,2015,111.0,"Crime,Drama,Mystery",6.3,37455
99,Under the Rainbow,20000000,18826490,18826490,37652980,17652980,en,3.705,2014-06-27,5.5,42,2013,112.0,"Comedy,Drama,Romance",5.9,1174
22,Lockout,20000000,14326865,33943049,48269914,28269914,en,11.273,2012-04-13,5.9,1004,2012,95.0,"Action,Sci-Fi,Thriller",6.1,89554
24,What's Your Number?,20000000,14011084,30163785,44174869,24174869,en,10.391,2011-09-30,6.4,1271,2011,106.0,"Comedy,Romance",6.1,67922
27,Burnt,20000000,13651946,36773510,50425456,30425456,en,12.761,2015-10-23,6.4,1841,2015,101.0,"Comedy,Drama",6.6,95988
33,Triple 9,20000000,12639297,25943792,38583089,18583089,en,13.334,2016-02-26,5.8,1258,2016,115.0,"Crime,Thriller",6.3,60369
34,The Light Between Oceans,20000000,12545979,22281732,34827711,14827711,en,29.887,2016-09-02,7.1,831,2016,133.0,"Drama,Romance",7.2,46247
38,Let Me In,20000000,12134935,28270399,40405334,20405334,en,9.716,2010-10-01,6.7,1061,2010,116.0,"Drama,Fantasy,Horror",7.1,107012
47,Popstar: Never Stop Never Stopping,20000000,9496130,9537120,19033250,-966750,en,11.844,2016-06-03,6.6,675,2016,87.0,"Comedy,Music",6.7,47278
48,Thank You for Your Service,20000000,9479390,9985316,19464706,-535294,en,0.6,2016-09-16,6.0,1,2015,88.0,"Documentary,Drama",7.7,74
49,Everybody's Fine,20000000,9208876,9208876,18417752,-1582248,zh,0.633,2016-01-29,6.0,1,2016,105.0,Drama,5.9,62
51,Battle of the Year,20000000,8888355,16723377,25611732,5611732,en,5.858,2013-09-21,6.1,130,2013,110.0,"Drama,Music",5.1,8769
56,Inherent Vice,20000000,8110975,14772346,22883321,2883321,en,14.244,2015-01-09,6.6,1359,2014,148.0,"Comedy,Crime,Drama",6.7,83346
58,Machete Kills,20000000,8008161,18273009,26281170,6281170,en,10.36,2013-10-11,5.5,1079,2013,107.0,"Action,Crime,Sci-Fi",5.6,69968
65,Little Boy,20000000,6485961,17769299,24255260,4255260,en,5.805,2015-04-23,7.0,292,2015,106.0,"Drama,History,War",7.4,20945
67,Chasing Mavericks,20000000,6002756,8300821,14303577,-5696423,en,6.546,2012-10-26,7.0,329,2012,116.0,"Biography,Drama,Sport",7.2,28994
68,A Most Violent Year,20000000,5749134,8846875,14596009,-5403991,en,12.271,2014-12-31,6.6,792,2014,125.0,"Crime,Drama,Thriller",7.0,60165
69,A Dangerous Method,20000000,5702083,14807531,20509614,509614,en,10.352,2011-11-23,6.3,1066,2011,99.0,"Biography,Drama,Romance",6.4,93259
74,Hands of Stone,20000000,4712792,5031975,9744767,-10255233,en,8.17,2016-08-26,6.1,167,2016,111.0,"Action,Biography,Drama",6.6,12851
78,The Cold Light of Day,20000000,3763583,25361206,29124789,9124789,en,8.974,2012-09-06,5.1,463,2012,93.0,"Action,Thriller",4.9,33039
81,Suspiria,20000000,2483472,7034615,9518087,-10481913,en,16.925,2018-10-26,7.0,752,2018,152.0,"Fantasy,Horror,Mystery",6.8,37360
82,LBJ,20000000,2468683,2507181,4975864,-15024136,en,6.304,2017-11-03,6.6,65,2016,98.0,"Biography,Drama,History",6.5,4396
90,Dylan Dog: Dead of Night,20000000,1186538,6093725,7280263,-12719737,en,7.508,2011-11-01,4.4,243,2010,107.0,"Action,Comedy,Crime",5.1,14120
96,All Good Things,20000000,582024,873617,1455641,-18544359,en,7.871,2010-12-03,6.0,493,2010,101.0,"Crime,Drama,Mystery",6.3,49684
97,By the Sea,20000000,538460,3727746,4266206,-15733794,en,6.471,2015-11-13,5.4,306,2015,122.0,"Drama,Romance",5.3,16206
1,The Tempest,20000000,277943,277943,555886,-19444114,en,6.3,2010-12-10,5.8,52,2010,110.0,"Comedy,Drama,Fantasy",5.4,7073
6,Regression,20000000,55039,15824374,15879413,-4120587,en,10.713,2016-02-05,5.5,1065,2015,106.0,"Crime,Horror,Mystery",5.7,33335
7,Admiral,20000000,0,38585047,38585047,18585047,nl,5.466,2016-03-11,6.4,86,2015,151.0,"Action,Adventure,Biography",7.0,7978
8,Zambezia,20000000,0,34454336,34454336,14454336,en,7.931,2012-07-07,5.6,131,2012,83.0,"Adventure,Animation,Comedy",5.8,6010
11,Survivor,20000000,0,1703281,1703281,-18296719,en,3.412,2012-08-29,4.8,55,2012,81.0,"Biography,Crime,Documentary",9.0,45
14,Dwegons and Leprechauns,20000000,0,0,0,-20000000,en,0.956,2014-01-24,0.8,2,2014,98.0,Animation,4.2,84
15,Fight Valley,20000000,0,0,0,-20000000,en,2.199,2016-07-22,3.5,14,2016,90.0,"Action,Drama",2.7,494
17,Bird Box,19800000,0,0,0,-19800000,en,26.156,2018-11-12,7.0,4777,2018,124.0,"Drama,Horror,Sci-Fi",6.6,218063
19,The Shape of Water,19500000,63859435,195790794,259650229,240150229,en,22.025,2017-12-01,7.2,7224,2017,123.0,"Adventure,Drama,Fantasy",7.3,308112
22,The Frozen Ground,19200000,0,5617460,5617460,-13582540,en,10.34,2013-08-23,6.3,762,2013,105.0,"Crime,Drama,Mystery",6.4,51915
23,The Devil's Double,19100000,1361512,5965646,7327158,-11772842,en,7.505,2011-07-29,6.7,291,2011,109.0,"Biography,Drama,Thriller",7.1,58342
27,Bad Teacher,19000000,100292856,215448997,315741853,296741853,en,13.549,2011-06-19,5.5,2894,2011,92.0,"Comedy,Romance",5.7,181189
28,Sausage Party,19000000,97670358,141344255,239014613,220014613,en,15.232,2016-08-12,5.6,4237,2016,89.0,"Adventure,Animation,Comedy",6.2,159111
36,The Crazies,19000000,39123589,56445534,95569123,76569123,en,12.246,2010-02-26,6.2,1036,2010,101.0,"Horror,Thriller",6.5,104465
39,The Switch,19000000,27758465,49858465,77616930,58616930,en,7.745,2010-08-20,6.1,1008,2010,101.0,"Comedy,Drama,Romance",6.1,90661
40,Leap Year,19000000,25918920,32618920,58537840,39537840,en,11.821,2010-01-08,6.7,990,2010,100.0,"Comedy,Romance",6.5,86125
41,The Book Thief,19000000,21488481,76086711,97575192,78575192,en,9.034,2013-11-08,7.5,2788,2013,131.0,"Drama,War",7.6,119023
48,Take Me Home Tonight,19000000,6928068,7576604,14504672,-4495328,en,11.321,2011-03-04,6.1,339,2011,97.0,"Comedy,Drama,Romance",6.3,48393
49,Won't Back Down,19000000,5310554,5745503,11056057,-7943943,en,6.14,2012-09-28,6.3,64,2012,121.0,Drama,6.4,5915
50,Action Point,19000000,5059608,5103675,10163283,-8836717,en,12.84,2018-06-01,5.2,136,2018,85.0,Comedy,5.0,6657
63,Left Behind,18500000,4221341,4221341,8442682,-10057318,en,13.897,2014-10-03,4.0,713,2012,86.0,"Horror,Mystery,Thriller",6.5,33
64,Neighbors,18000000,150086800,270944428,421031228,403031228,en,14.979,2014-05-09,6.2,4536,2014,97.0,Comedy,6.3,266020
67,Big,18000000,114968774,151668774,266637548,248637548,en,15.031,1988-06-03,7.0,1813,2017,99.0,Documentary,8.5,6
77,My Big Fat Greek Wedding 2,18000000,59689605,92096558,151786163,133786163,en,6.714,2016-03-25,5.8,593,2016,94.0,"Comedy,Romance",6.0,25933
78,The Perfect Guy,18000000,57027435,60278166,117305601,99305601,en,6.727,2015-09-11,5.7,211,2015,100.0,"Crime,Drama,Horror",5.6,8998
80,Diary of a Wimpy Kid: Rodrick Rules,18000000,52698535,73695194,126393729,108393729,en,8.961,2011-03-25,6.4,492,2011,99.0,"Comedy,Family",6.6,23135
83,Soul Surfer,18000000,43853424,47158652,91012076,73012076,en,8.459,2011-04-08,7.0,688,2011,112.0,"Biography,Drama,Family",7.1,41659
85,Uncle Drew,18000000,42469946,46527161,88997107,70997107,en,10.836,2018-06-29,6.5,220,2018,103.0,"Comedy,Sport",5.7,9739
90,Blue Jasmine,18000000,33404871,102912961,136317832,118317832,en,10.443,2013-07-26,7.0,1983,2013,98.0,Drama,7.3,179453
92,Honey,18000000,30272254,62646763,92919017,74919017,en,2.288,2011-03-25,7.1,39,2010,103.0,Drama,7.2,6221
95,Ricki and the Flash,18000000,26839498,41166033,68005531,50005531,en,8.247,2015-08-07,5.8,473,2015,101.0,"Comedy,Drama,Music",5.9,20932
98,Love the Coopers,18000000,26302731,42227490,68530221,50530221,en,8.261,2015-11-13,5.8,384,2015,107.0,"Comedy,Fantasy,Romance",5.8,18018
4,The Circle,18000000,20497844,40651864,61149708,43149708,sv,2.398,2015-10-13,5.5,48,2015,144.0,"Drama,Fantasy,Horror",5.9,2396
6,127 Hours,18000000,18335230,60217171,78552401,60552401,en,11.435,2010-11-05,7.0,4469,2010,94.0,"Adventure,Biography,Drama",7.6,323949
9,Norm of the North,18000000,17062499,30535660,47598159,29598159,en,9.325,2016-01-15,4.2,192,2016,90.0,"Adventure,Animation,Comedy",3.6,7951
11,Jobs,18000000,16131410,43402515,59533925,41533925,en,8.023,2013-08-16,6.1,1622,2013,128.0,"Biography,Drama",5.9,88788
14,And So It Goes,18000000,15160801,17920013,33080814,15080814,en,8.235,2014-07-25,5.9,264,2014,94.0,"Comedy,Drama,Romance",5.8,11597
19,Labor Day,18000000,13371528,14189810,27561338,9561338,en,9.258,2013-12-27,6.9,546,2013,111.0,"Drama,Romance",6.9,39242
20,Getaway,18000000,10501938,11813989,22315927,4315927,en,10.793,2013-08-29,5.1,380,2013,90.0,"Action,Crime,Thriller",4.4,22157
26,Dragonslayer,18000000,6000000,6000000,12000000,-6000000,en,1.155,2011-11-04,4.5,2,2011,74.0,Documentary,5.8,516
33,The Railway Man,18000000,4438438,23910210,28348648,10348648,en,9.582,2014-04-11,6.9,408,2013,116.0,"Biography,Drama,Romance",7.1,34586
34,Restoration,18000000,4100000,4100000,8200000,-9800000,en,1.661,2016-05-03,4.7,21,2011,102.0,Drama,6.8,207
35,Midnight Special,18000000,3712282,7680250,11392532,-6607468,en,8.653,2016-03-18,6.3,1105,2016,112.0,"Action,Drama,Mystery",6.6,67921
36,Miss Sloane,18000000,3500605,7719630,11220235,-6779765,en,12.215,2016-11-25,7.4,912,2016,132.0,"Drama,Thriller",7.5,52788
39,Unforgettable,18000000,2483790,2483790,4967580,-13032420,en,8.323,2017-04-21,5.5,310,2010,88.0,Documentary,5.9,7
43,Phantom,18000000,1034589,1199510,2234099,-15765901,en,7.211,2013-03-01,6.0,151,2013,98.0,"Drama,History,Thriller",5.9,12786
50,I Am Wrath,18000000,0,309608,309608,-17690392,en,9.558,2016-05-13,4.9,296,2016,92.0,"Action,Crime,Drama",5.4,11198
51,Wolves,18000000,0,94953,94953,-17905047,en,8.627,2014-11-14,5.8,151,2014,91.0,"Action,Fantasy,Horror",5.3,7312
53,The Prince,18000000,0,0,0,-18000000,en,12.324,2014-08-22,4.8,317,2014,93.0,"Action,Thriller",4.6,16048
54,Forsaken,18000000,0,0,0,-18000000,en,9.472,2016-02-19,5.9,161,2015,90.0,"Action,Drama,Western",6.3,9199
56,Red Lights,17700000,49521,14518884,14568405,-3131595,en,8.25,2012-07-12,6.1,615,2012,114.0,"Drama,Fantasy,Horror",6.2,55287
63,Black Nativity,17500000,7018188,7285135,14303323,-3196677,en,1.779,2013-11-27,5.7,25,2013,93.0,"Drama,Family,Music",4.6,1901
64,City of Ghosts,17500000,325491,325491,650982,-16849018,en,4.341,2017-07-14,7.1,24,2017,92.0,"Documentary,War",7.4,2925
66,A Quiet Place,17000000,188024361,334522294,522546655,505546655,en,29.154,2018-04-06,7.3,5848,2016,80.0,Documentary,6.6,18
73,The Best Man Holiday,17000000,70525195,72835710,143360905,126360905,en,8.581,2013-11-15,6.6,145,2013,123.0,"Comedy,Drama",6.7,13967
75,Pitch Perfect,17000000,65001093,116044347,181045440,164045440,en,13.886,2012-09-28,7.3,4233,2012,112.0,"Comedy,Music,Romance",7.2,256565
77,Evil Dead,17000000,54239856,97778356,152018212,135018212,en,13.089,2013-04-05,6.4,2664,2013,91.0,"Fantasy,Horror,Thriller",6.5,146399
80,"McFarland, USA",17000000,44480275,45707924,90188199,73188199,en,8.197,2015-02-20,7.3,358,2015,129.0,"Biography,Drama,Sport",7.4,31735
81,Almost Christmas,17000000,42065185,42493506,84558691,67558691,en,6.532,2016-11-11,5.6,245,2016,111.0,"Comedy,Drama",6.1,5212
87,Beastly,17000000,27865571,38028230,65893801,48893801,en,10.136,2011-03-04,6.1,1748,2011,86.0,"Drama,Fantasy,Romance",5.6,72599
90,Lottery Ticket,17000000,24719879,24719879,49439758,32439758,en,7.699,2010-08-20,5.7,92,2010,99.0,Comedy,5.0,10042
4,The Apparition,17000000,4936819,10637281,15574100,-1425900,en,7.714,2012-08-24,4.3,221,2012,83.0,"Horror,Thriller",4.1,18112
10,Genius,17000000,1361045,7265283,8626328,-8373672,en,9.417,2016-06-10,6.5,391,2016,104.0,"Biography,Drama",6.6,15611
12,Escobar: Paradise Lost,17000000,195792,3917679,4113471,-12886529,en,15.924,2014-10-11,6.3,476,2014,120.0,"Crime,Drama,History",6.5,19419
16,Crawl,17000000,0,0,0,-17000000,en,1.937,2011-10-15,5.6,18,2011,80.0,"Crime,Thriller",4.7,1095
17,The Young Messiah,16800000,6469813,7313697,13783510,-3016490,en,5.531,2016-03-11,6.1,50,2016,111.0,"Drama,Fantasy",5.6,2882
22,The Illusionist,16500000,39868642,83792062,123660704,107160704,fr,8.404,2010-12-25,7.4,280,2010,80.0,"Animation,Drama",7.5,31734
33,Moonrise Kingdom,16000000,45512466,68848446,114360912,98360912,en,14.086,2012-05-25,7.7,3023,2012,94.0,"Adventure,Comedy,Drama",7.8,291750
34,The Artist,16000000,44667095,128256712,172923807,156923807,en,10.155,2011-10-14,7.4,1787,2011,100.0,"Comedy,Drama,Romance",7.9,217184
39,The Roommate,16000000,37300107,52545707,89845814,73845814,en,8.134,2011-02-04,5.4,406,2011,91.0,"Drama,Thriller",4.9,33062
51,Remember Me,16000000,19068240,56506120,75574360,59574360,en,11.453,2010-03-12,7.1,2079,2010,113.0,"Drama,Romance",7.1,129443
60,People Like Us,16000000,12431792,12617472,25049264,9049264,en,9.078,2012-06-29,6.8,360,2012,114.0,"Comedy,Drama",7.1,39618
65,Bleed for This,16000000,5083906,6603926,11687832,-4312168,en,8.258,2016-11-04,6.9,405,2016,117.0,"Biography,Drama,Sport",6.8,21946
70,The Homesman,16000000,2429989,8217571,10647560,-5352440,en,8.232,2014-08-29,6.5,389,2014,122.0,"Drama,Western",6.6,27724
71,Trance,16000000,2322593,22594052,24916645,8916645,en,9.571,2013-04-05,6.6,1348,2010,83.0,Horror,4.6,77
72,The Immigrant,16000000,2013456,7585011,9598467,-6401533,en,8.145,2013-10-06,6.2,438,2013,120.0,"Drama,Romance",6.6,26618
73,Steel,16000000,1686429,1686429,3372858,-12627142,en,2.742,2015-11-17,6.8,11,2012,95.0,Drama,5.7,264
79,Vamps,16000000,3361,94812,98173,-15901827,en,6.65,2012-11-02,5.0,145,2012,92.0,"Comedy,Horror,Romance",5.2,8838
83,Second Act,15700000,39282227,63288854,102571081,86871081,en,16.322,2018-12-21,6.2,361,2018,103.0,"Comedy,Drama,Romance",5.8,13109
2,Annabelle: Creation,15000000,102092201,305384865,407477066,392477066,en,21.245,2017-08-11,6.5,3141,2017,109.0,"Horror,Mystery,Thriller",6.5,90402
6,The Imitation Game,15000000,91125143,227740463,318865606,303865606,en,33.078,2014-12-19,8.1,10396,2014,114.0,"Biography,Drama,Thriller",8.0,620834
9,Mama,15000000,71628180,148095566,219723746,204723746,en,11.983,2013-01-18,6.1,2421,2010,50.0,Drama,4.5,6
13,Diary of a Wimpy Kid,15000000,64003625,76954311,140957936,125957936,en,12.256,2010-03-19,6.0,736,2010,94.0,"Comedy,Drama,Family",6.2,38640
15,Halloween,15000000,58269151,77514401,135783552,120783552,en,20.839,2018-10-19,6.4,2020,2018,106.0,"Horror,Thriller",6.6,88395
18,The Woman in Black,15000000,54333290,128955898,183289188,168289188,en,12.781,2012-02-03,6.1,2122,2012,95.0,"Drama,Fantasy,Horror",6.4,165357
19,Little Women,15000000,50003303,50003303,100006606,85006606,en,2.919,2018-09-28,6.8,11,2018,112.0,"Drama,Family",4.6,626
21,BlacKkKlansman,15000000,49275340,93017335,142292675,127292675,en,25.101,2018-07-30,7.6,3138,2018,135.0,"Biography,Crime,Drama",7.5,149005
26,Snitch,15000000,42930462,57907734,100838196,85838196,en,0.6,2011-01-01,1.0,1,2013,112.0,"Action,Drama,Thriller",6.5,78142
28,Krampus,15000000,42725475,61788393,104513868,89513868,en,9.417,2015-12-04,6.0,1046,2015,98.0,"Comedy,Fantasy,Horror",6.2,55400
29,End of Watch,15000000,41003371,57586606,98589977,83589977,en,13.152,2012-09-21,7.3,1770,2012,109.0,"Action,Crime,Drama",7.6,211308
33,Wild,15000000,37880356,52460543,90340899,75340899,en,10.098,2014-12-05,7.0,1454,2014,115.0,"Adventure,Biography,Drama",7.1,110138
35,The Theory of Everything,15000000,35893537,123327692,159221229,144221229,en,13.866,2014-11-26,7.9,6412,2014,123.0,"Biography,Drama,Romance",7.7,361534
36,Drive,15000000,35060689,81357930,116418619,101418619,en,15.875,2011-09-16,7.5,6737,2011,100.0,"Crime,Drama",7.8,521495
39,The Favourite,15000000,34366783,94113929,128480712,113480712,en,28.651,2018-11-23,7.7,2096,2018,119.0,"Biography,Drama,History",7.6,116011
50,When the Game Stands Tall,15000000,30127963,30138912,60266875,45266875,en,6.08,2014-08-22,6.6,185,2014,115.0,"Drama,Family,Sport",6.7,14498
57,Home Again,15000000,27020284,37336874,64357158,49357158,en,10.478,2017-09-08,5.9,659,2012,104.0,Drama,6.6,360
60,Ramona and Beezus,15000000,26167002,27469621,53636623,38636623,en,7.442,2010-07-23,6.3,460,2010,103.0,"Adventure,Comedy,Family",6.6,16086
61,The November Man,15000000,25018119,34820335,59838454,44838454,en,17.747,2014-08-27,6.1,852,2014,108.0,"Action,Crime,Thriller",6.3,59293
67,The Place Beyond the Pines,15000000,21403519,47011449,68414968,53414968,en,12.96,2013-03-27,6.9,2781,2012,140.0,"Crime,Drama,Thriller",7.3,226765
70,Keanu,15000000,20591853,20688141,41279994,26279994,en,8.952,2016-04-29,6.0,644,2016,100.0,"Action,Comedy,Crime",6.3,41560
71,Country Strong,15000000,20218921,20601987,40820908,25820908,en,7.567,2010-12-22,6.3,126,2010,117.0,"Drama,Music",6.3,16296
76,A Most Wanted Man,15000000,17237855,36068890,53306745,38306745,en,10.267,2014-07-25,6.5,784,2014,122.0,"Crime,Drama,Thriller",6.8,67914
79,The Man with the Iron Fists,15000000,15634090,22018988,37653078,22653078,en,15.457,2012-11-02,5.3,573,2012,95.0,Action,5.4,58185
81,Miss Bala,15000000,14998027,15362298,30360325,15360325,es,10.128,2011-10-01,6.3,50,2011,113.0,"Crime,Drama,Thriller",6.5,8092
82,Killing Them Softly,15000000,14945541,39238443,54183984,39183984,en,11.298,2012-11-30,6.0,1105,2012,97.0,"Crime,Thriller",6.2,124086
84,One Day,15000000,13843771,59168692,73012463,58012463,en,10.308,2011-08-19,7.2,2105,2011,107.0,"Drama,Romance",7.0,128094
90,The Founder,15000000,12786053,24403192,37189245,22189245,en,12.349,2017-01-20,7.0,2093,2012,108.0,"Comedy,Sci-Fi",5.9,33
6,Queen of Katwe,15000000,8874389,10055481,18929870,3929870,en,7.564,2016-09-23,7.1,225,2016,124.0,"Biography,Drama,Sport",7.4,13039
13,Promised Land,15000000,7597898,12394562,19992460,4992460,en,8.702,2012-12-28,6.2,378,2012,106.0,Drama,6.6,34659
15,Hotel Artemis,15000000,6708137,12758799,19466936,4466936,en,14.585,2018-06-08,5.9,471,2018,94.0,"Action,Drama,Sci-Fi",6.1,30586
25,Scouts Guide to the Zombie Apocalypse,15000000,3703046,15554855,19257901,4257901,en,10.451,2015-10-30,6.2,915,2015,93.0,"Action,Comedy,Horror",6.3,40479
27,You Will Meet a Tall Dark Stranger,15000000,3247816,34247816,37495632,22495632,en,6.209,2010-05-23,5.8,431,2010,98.0,"Comedy,Drama,Romance",6.3,41608
28,Rock the Kasbah,15000000,3020665,3386153,6406818,-8593182,en,5.203,2015-10-23,5.5,154,2015,106.0,"Comedy,Music,War",5.5,9587
29,Never Let Me Go,15000000,2434652,11173718,13608370,-1391630,en,10.012,2010-09-15,6.8,1294,2010,103.0,"Drama,Romance,Sci-Fi",7.1,130084
30,The Disappointments Room,15000000,2423467,3503761,5927228,-9072772,en,6.324,2016-09-09,4.4,272,2016,85.0,"Drama,Horror,Thriller",3.9,8167
35,The Comedian,15000000,1658706,1658706,3317412,-11682588,en,7.433,2016-12-09,5.6,68,2012,79.0,"Drama,Romance",5.5,328
42,The Reluctant Fundamentalist,15000000,528731,528731,1057462,-13942538,en,7.46,2013-03-17,6.7,120,2012,130.0,"Drama,Thriller",6.9,12511
43,The Return,15000000,501752,5953886,6455638,-8544362,en,0.6,2016-04-17,7.0,2,2012,102.0,Drama,7.2,233
46,Centurion,15000000,123570,7885048,8008618,-6991382,en,13.548,2010-02-15,6.1,673,2010,97.0,"Action,Adventure,Drama",6.4,74085
50,Winnie Mandela,15000000,61847,61847,123694,-14876306,en,1.88,2013-09-06,5.7,6,2011,104.0,"Biography,Drama,History",6.0,695
51,The Son of No One,15000000,30680,1148578,1179258,-13820742,en,7.586,2011-11-04,5.1,156,2011,90.0,"Action,Crime,Drama",5.1,15743
54,Khumba,15000000,0,20898221,20898221,5898221,en,9.597,2013-12-07,5.6,129,2013,85.0,"Adventure,Animation,Family",5.7,4984
55,A Few Best Men,15000000,0,17224539,17224539,2224539,en,8.84,2011-10-14,5.8,247,2011,97.0,"Comedy,Romance",5.7,12069
61,In Dubious Battle,15000000,0,214182,214182,-14785818,en,7.646,2017-02-17,5.9,67,2016,110.0,Drama,6.1,3189
62,Broken Horses,15000000,0,3471,3471,-14996529,en,5.481,2015-04-10,5.4,17,2015,101.0,"Action,Crime,Drama",5.7,1957
66,Magic Mike XXL,14500000,66013057,123660597,189673654,175173654,en,8.681,2015-07-01,6.2,1110,2015,115.0,"Comedy,Drama,Music",5.6,48497
81,The Possession,14000000,49130588,82925064,132055652,118055652,en,8.978,2012-08-31,5.9,918,2012,92.0,"Horror,Mystery,Thriller",5.9,53649
87,White Fang,14000000,34729091,34729091,69458182,55458182,fr,15.879,2018-01-21,7.2,69,2018,85.0,"Adventure,Animation",7.0,2048
89,Superstar,14000000,30628981,30628981,61257962,47257962,fr,3.535,2012-09-09,5.3,49,2012,112.0,Drama,5.3,834
90,The Iron Lady,14000000,29959436,115592104,145551540,131551540,en,8.987,2011-12-30,6.4,899,2011,105.0,"Biography,Drama",6.4,96066
95,Our Family Wedding,14000000,20255281,21410546,41665827,27665827,en,5.025,2010-03-12,5.5,57,2010,103.0,"Comedy,Romance",4.9,6417
7,Hot Tub Time Machine 2,14000000,12314651,12826644,25141295,11141295,en,8.053,2015-02-20,5.1,512,2015,93.0,"Comedy,Mystery,Sci-Fi",5.1,34444
8,Bobby,14000000,11242801,20597806,31840607,17840607,en,1.881,2016-05-27,6.6,10,2016,97.0,"Biography,Documentary,Sport",7.1,383
10,Fun Size,14000000,9409538,11166615,20576153,6576153,en,7.072,2012-10-26,5.5,249,2012,86.0,"Adventure,Comedy",5.4,12926
16,Suffragette,14000000,4702420,34044909,38747329,24747329,en,7.763,2015-10-23,7.3,982,2015,106.0,"Biography,Drama,History",6.9,34306
18,Mr. Turner,14000000,3958546,25187026,29145572,15145572,en,7.884,2014-12-19,6.5,301,2014,150.0,"Biography,Drama,History",6.8,22661
22,Flipped,14000000,1755212,4289993,6045205,-7954795,en,9.781,2010-08-06,7.4,859,2010,90.0,"Comedy,Drama,Romance",7.7,74937
27,Margaret,14000000,47185,623292,670477,-13329523,en,8.747,2011-09-30,6.3,138,2011,150.0,Drama,6.5,14708
28,Reign of Assassins,14000000,0,11354230,11354230,-2645770,zh,7.621,2010-09-01,6.8,87,2010,117.0,"Action,Adventure",6.9,6990
32,Ca$h,13700000,0,11738256,11738256,-1961744,en,8.503,2010-01-01,5.8,112,2010,108.0,"Crime,Thriller",6.0,8605
36,Seven Psychopaths,13500000,15024049,33035736,48059785,34559785,en,10.967,2012-10-12,6.8,2109,2012,110.0,"Comedy,Crime",7.2,223493
41,The Last Godfather,13400000,164247,164247,328494,-13071506,ko,1.4,2011-04-11,4.9,9,2010,100.0,"Comedy,Crime,Romance",3.7,1071
42,Under the Skin,13300000,2614251,7229933,9844184,-3455816,en,9.527,2014-04-04,6.1,1781,2013,108.0,"Drama,Horror,Sci-Fi",6.3,113196
44,No Good Deed,13200000,52543632,54323210,106866842,93666842,en,14.519,2014-09-12,5.8,286,2014,84.0,"Action,Crime,Drama",5.6,16045
46,Black Swan,13000000,106954678,331266710,438221388,425221388,en,13.745,2010-12-03,7.6,8374,2010,108.0,"Drama,Thriller",8.0,648854
48,Justin Bieber: Never Say Never,13000000,73013910,99034125,172048035,159048035,en,8.602,2011-02-11,5.1,240,2011,105.0,"Documentary,Music",1.6,74978
49,The First Purge,13000000,69488745,136617305,206106050,193106050,en,28.44,2018-07-04,5.8,1846,2018,98.0,"Action,Horror,Sci-Fi",5.1,41741
50,Miracles from Heaven,13000000,61705123,73798736,135503859,122503859,en,10.078,2016-03-18,7.1,478,2016,109.0,"Biography,Drama,Family",7.1,17734
54,The Shallows,13000000,55121623,118763442,173885065,160885065,en,14.091,2016-06-24,6.3,3037,2016,86.0,"Drama,Horror,Thriller",6.3,106927
58,About Last Night,13000000,48637684,50445860,99083544,86083544,en,8.465,2014-02-14,6.0,312,2014,100.0,"Comedy,Romance",6.1,21078
61,St. Vincent,13000000,44137712,54837234,98974946,85974946,en,16.379,2014-10-31,7.1,1069,2014,102.0,"Comedy,Drama",7.3,89372
62,Earth to Echo,13000000,38934842,42174545,81109387,68109387,en,7.189,2014-07-02,5.7,377,2014,91.0,"Adventure,Family,Sci-Fi",5.8,17627
72,Ex Machina,13000000,25440971,38358392,63799363,50799363,en,18.485,2015-04-10,7.6,8026,2014,108.0,"Drama,Mystery,Sci-Fi",7.7,424542
75,Eye in the Sky,13000000,18704596,35402802,54107398,41107398,en,10.219,2016-03-11,7.1,850,2015,102.0,"Drama,Thriller,War",7.3,72301
76,Admission,13000000,18007317,18733666,36740983,23740983,en,8.065,2013-03-22,5.5,385,2013,107.0,"Comedy,Drama,Romance",5.7,31849
77,The Perks of Being a Wallflower,13000000,17742948,33069303,50812251,37812251,en,15.148,2012-09-21,7.8,5938,2012,103.0,Drama,8.0,422671
80,Room,13000000,14677674,36262783,50940457,37940457,en,20.0,2015-10-16,8.1,5494,2015,118.0,"Drama,Thriller",8.2,316791
81,Woodlawn,13000000,14394097,14403703,28797800,15797800,en,5.575,2015-10-16,7.0,79,2015,123.0,"Drama,Sport",6.5,6070
86,Bajrangi Bhaijaan,13000000,8178001,121778347,129956348,116956348,hi,7.122,2015-07-17,7.9,232,2015,163.0,"Action,Comedy,Drama",8.0,63747
97,Chloe,13000000,3075255,11831131,14906386,1906386,en,8.807,2010-03-26,5.9,940,2013,73.0,"Drama,Music,Romance",6.9,34
99,Youth,13000000,2703296,24001573,26704869,13704869,he,1.008,2013-10-12,5.3,9,2012,75.0,"Drama,Family",6.6,36
3,The Vatican Tapes,13000000,1784763,14929184,16713947,3713947,en,7.841,2015-07-24,4.6,365,2015,91.0,"Horror,Thriller",5.0,14822
7,Attack the Block,13000000,1024175,6459183,7483358,-5516642,en,9.612,2011-07-29,6.4,1144,2011,88.0,"Action,Comedy,Sci-Fi",6.7,93868
11,The Killer Inside Me,13000000,217277,3617277,3834554,-9165446,en,7.087,2010-04-27,5.9,304,2010,109.0,"Crime,Drama,Horror",6.1,31727
12,Womb,13000000,0,0,0,-13000000,en,8.483,2010-07-15,6.1,159,2010,111.0,"Drama,Romance,Sci-Fi",6.4,12489
14,The Call,12800000,51872378,69821476,121693854,108893854,en,11.315,2013-03-14,6.7,1779,2013,94.0,"Crime,Drama,Horror",6.7,103780
16,The Drop,12600000,10724389,19054534,29778923,17178923,en,14.795,2014-09-12,6.7,1215,2014,106.0,"Crime,Drama",7.1,132161
18,Machete,12500000,26593646,46370970,72964616,60464616,en,12.557,2010-09-03,6.3,1862,2010,105.0,"Action,Crime,Thriller",6.6,182320
28,Conviction,12500000,6797696,11826980,18624676,6124676,en,7.51,2010-10-15,7.2,297,2010,107.0,"Biography,Crime,Drama",7.2,39771
32,Casino Jack,12500000,2039869,2272186,4312055,-8187945,en,9.432,2010-12-17,6.1,149,2010,108.0,"Biography,Comedy,Crime",6.2,16191
37,The Paperboy,12500000,677200,4027663,4704863,-7795137,en,8.143,2012-10-05,5.5,409,2012,107.0,"Crime,Drama,Mystery",5.8,33940
39,A Little Bit of Heaven,12500000,10011,1100287,1110298,-11389702,en,7.87,2011-02-03,6.3,333,2011,106.0,"Comedy,Drama,Fantasy",6.3,26441
43,The Fault in Our Stars,12000000,124872350,307166834,432039184,420039184,en,16.03,2014-05-16,7.6,7236,2014,126.0,"Drama,Romance",7.7,315135
45,Think Like a Man,12000000,91547205,113373764,204920969,192920969,en,5.905,2012-04-20,6.9,438,2012,122.0,"Comedy,Romance",6.6,41043
52,Act of Valor,12000000,70012847,82497035,152509882,140509882,en,12.197,2012-02-24,6.3,583,2012,110.0,"Action,Adventure,Drama",6.5,63787
55,Chronicle,12000000,64575175,123681790,188256965,176256965,en,12.556,2012-02-02,6.7,3084,2012,84.0,"Drama,Sci-Fi,Thriller",7.1,229258
58,Project X,12000000,54731865,103028188,157760053,145760053,en,9.715,2012-03-02,6.4,2968,2012,88.0,Comedy,6.7,177782
59,"Three Billboards Outside Ebbing, Missouri",12000000,54513740,160191915,214705655,202705655,en,17.808,2017-11-10,8.2,5432,2017,115.0,"Crime,Drama",8.2,344047
60,Lion,12000000,51739495,149570720,201310215,189310215,en,17.216,2016-11-25,8.1,3833,2016,118.0,"Biography,Drama",8.1,181601
61,Overboard,12000000,50316123,85369830,135685953,123685953,en,19.477,2018-05-04,6.3,535,2018,112.0,"Comedy,Romance",5.9,25607
65,Philomena,12000000,37709979,98963392,136673371,124673371,en,8.978,2013-11-27,7.4,945,2013,98.0,"Biography,Comedy,Drama",7.6,88704
67,Crossroads,12000000,37188667,57000000,94188667,82188667,en,0.6,2017-10-14,4.0,1,2011,,Drama,5.4,36
68,Paper Towns,12000000,32000304,85450484,117450788,105450788,en,11.564,2015-07-24,6.0,3587,2015,109.0,"Comedy,Drama,Mystery",6.3,87742
77,Hell or High Water,12000000,27007844,37584304,64592148,52592148,en,15.749,2016-08-12,7.3,2468,2016,102.0,"Action,Crime,Drama",7.6,176469
79,Katy Perry: Part of Me,12000000,25326071,32700439,58026510,46026510,en,7.139,2012-07-05,6.8,147,2012,93.0,"Documentary,Music",5.9,13034
80,Top Five,12000000,25317379,26001741,51319120,39319120,en,6.322,2014-12-12,6.3,281,2014,102.0,"Comedy,Romance",6.4,24744
84,Project Almanac,12000000,22348241,32909437,55257678,43257678,en,9.55,2015-01-30,6.5,1449,2015,106.0,"Drama,Mystery,Sci-Fi",6.4,71500
85,Just Wright,12000000,21540363,21867665,43408028,31408028,en,7.047,2010-05-14,6.2,211,2010,100.0,"Comedy,Romance,Sport",5.9,12466
91,Nebraska,12000000,17654912,24761360,42416272,30416272,en,9.521,2013-11-15,7.4,967,2013,115.0,"Adventure,Comedy,Drama",7.7,105304
94,Young Adult,12000000,16311571,22750356,39061927,27061927,en,8.335,2011-12-16,5.7,603,2011,94.0,"Comedy,Drama",6.3,74071
95,About Time,12000000,15323921,89309178,104633099,92633099,en,14.133,2013-11-08,7.9,3981,2013,123.0,"Comedy,Drama,Fantasy",7.8,263136
96,If Beale Street Could Talk,12000000,14915773,19859167,34774940,22774940,en,13.579,2018-12-14,7.2,388,2018,119.0,"Drama,Romance",7.2,25512
97,Wish Upon,12000000,14301505,23477345,37778850,25778850,en,10.219,2017-07-14,5.4,690,2017,90.0,"Drama,Fantasy,Horror",5.0,14962
7,Marshall,12000000,10051659,10116816,20168475,8168475,en,7.879,2017-10-13,7.3,257,2017,118.0,"Biography,Crime,Drama",7.2,14419
9,Arbitrage,12000000,7919574,35830713,43750287,31750287,en,12.14,2012-09-14,6.2,459,2012,107.0,"Drama,Thriller",6.6,46774
11,Screwed,12000000,6982680,6982680,13965360,1965360,en,1.945,2013-10-19,5.0,6,2011,110.0,"Crime,Drama",5.7,1900
13,Fortress,12000000,6730578,46730578,53461156,41461156,en,4.738,2012-04-01,5.4,21,2012,70.0,"Documentary,Drama,News",7.0,31
14,For Greater Glory: The True Story of Cristiada,12000000,5669081,10026255,15695336,3695336,en,4.519,2012-06-01,6.6,63,2012,145.0,"Drama,History,War",6.6,4202
27,Ravenous,12000000,2062406,2062406,4124812,-7875188,fr,8.48,2017-09-23,5.4,123,2017,104.0,"Drama,Horror,Sci-Fi",5.9,5970
29,Stoker,12000000,1703125,12034913,13738038,1738038,en,10.738,2013-03-01,6.6,1282,2013,99.0,"Drama,Thriller",6.8,97393
32,Kill the Irishman,12000000,1188194,1188194,2376388,-9623612,en,7.13,2011-03-11,6.9,274,2011,106.0,"Biography,Crime,Drama",7.1,41504
34,Darling Companion,12000000,793352,1200346,1993698,-10006302,en,4.656,2012-04-20,5.0,46,2012,103.0,"Comedy,Drama,Romance",5.1,3085
36,Brother,12000000,450594,450594,901188,-11098812,es,1.636,2010-08-19,6.7,15,2010,97.0,"Drama,Family,Sport",7.4,2381
46,Trash,12000000,17484,6553186,6570670,-5429330,es,0.6,2010-11-03,3.0,3,2010,,Action,7.2,8
47,5 Days of War,12000000,17479,87793,105272,-11894728,en,8.689,2011-08-18,5.7,102,2011,113.0,"Action,Drama,War",5.6,13089
48,10 Days in a Madhouse,12000000,14616,14616,29232,-11970768,en,0.955,2015-11-20,5.4,7,2015,111.0,Drama,6.7,1114
52,Triangle,12000000,0,1594955,1594955,-10405045,en,7.761,2010-02-02,6.8,1094,2012,,Drama,6.9,10
54,Drive Hard,12000000,0,0,0,-12000000,en,6.957,2014-10-03,4.0,94,2014,92.0,"Action,Comedy,Crime",4.4,3907
60,Carol,11800000,12711491,42843521,55555012,43755012,en,13.096,2015-11-20,7.4,1949,2015,118.0,"Drama,Romance",7.2,100680
62,Dirty Grandpa,11500000,35593113,105078449,140671562,129171562,en,11.432,2016-01-22,5.8,2667,2016,102.0,Comedy,5.9,101393
68,The Fighter,11000000,93617009,129262388,222879397,211879397,en,10.395,2010-12-17,7.3,2325,2010,116.0,"Biography,Drama,Sport",7.8,316539
73,If I Stay,11000000,50474843,78356170,128831013,117831013,en,12.047,2014-08-22,7.4,2703,2014,107.0,"Drama,Fantasy,Music",6.8,107625
79,Brooklyn,11000000,38322743,62076141,100398884,89398884,en,12.083,2015-11-04,7.3,1912,2015,117.0,"Drama,Romance",7.5,117021
81,Woman in Gold,11000000,33307793,58586407,91894200,80894200,en,7.76,2015-04-10,7.4,787,2015,109.0,"Biography,Drama,History",7.3,48501
83,"I, Tonya",11000000,30014534,53797409,83811943,72811943,en,15.407,2017-12-08,7.5,2904,2017,120.0,"Biography,Comedy,Drama",7.5,141668
90,Quartet,11000000,18388357,56178935,74567292,63567292,en,8.32,2013-01-10,6.6,209,2012,94.0,"Comedy,Drama",6.8,17979
94,Inside Llewyn Davis,11000000,13248209,32943247,46191456,35191456,en,10.549,2013-12-06,7.2,1400,2013,104.0,"Drama,Music",7.5,123759
98,Peeples,11000000,9177065,9307166,18484231,7484231,en,2.651,2013-05-09,5.2,34,2013,95.0,"Comedy,Romance",5.3,4452
2,The Gospel of John,11000000,4068087,4234355,8302442,-2697558,en,0.6,2014-12-01,5.4,5,2014,160.0,Drama,7.8,563
11,Brighton Rock,11000000,229653,229653,459306,-10540694,en,4.749,2011-08-26,6.0,57,2010,111.0,"Crime,Drama,Thriller",5.7,5784
14,LOL,11000000,0,10431506,10431506,-568494,en,12.43,2012-05-04,6.1,1810,2012,97.0,"Comedy,Drama,Romance",4.4,51424
15,Misconduct,11000000,0,2352511,2352511,-8647489,en,7.299,2016-02-05,5.5,301,2016,106.0,"Crime,Drama,Mystery",5.3,13550
25,The Last Days on Mars,10600000,24084,261364,285448,-10314552,en,8.759,2013-12-06,5.3,407,2013,98.0,"Adventure,Horror,Sci-Fi",5.5,33137
33,Lovesick,10100000,10143618,10143618,20287236,10187236,en,4.775,2014-04-24,5.0,44,2011,90.0,"Comedy,Fantasy,Romance",5.0,126
42,The Purge: Election Year,10000000,79042440,118514727,197557167,187557167,en,18.975,2016-07-01,6.3,2900,2016,108.0,"Action,Horror,Sci-Fi",6.0,80254
43,Book Club,10000000,68566296,91113683,159679979,149679979,en,0.6,2015-05-13,10.0,1,2015,72.0,Documentary,6.6,9
45,Insidious: The Last Key,10000000,67745330,167885588,235630918,225630918,en,16.017,2018-01-05,6.1,1306,2018,103.0,"Horror,Mystery,Thriller",5.7,42154
53,Lady Bird,10000000,48958273,78610769,127569042,117569042,en,15.974,2017-11-03,7.3,3866,2017,94.0,"Comedy,Drama",7.4,177677
55,The Best Exotic Marigold Hotel,10000000,46383639,134639780,181023419,171023419,en,8.665,2012-05-25,6.9,756,2011,124.0,"Comedy,Drama,Romance",7.3,85811
56,Hereditary,10000000,44069456,70133905,114203361,104203361,en,26.185,2018-06-08,7.0,2491,2018,127.0,"Drama,Horror,Mystery",7.3,151571
57,"Love, Simon",10000000,40826341,65520633,106346974,96346974,en,15.608,2018-03-16,8.2,3165,2018,110.0,"Comedy,Drama,Romance",7.6,81575
61,Jigsaw,10000000,38052832,102445196,140498028,130498028,en,17.398,2017-10-27,6.1,1887,2017,92.0,"Crime,Horror,Mystery",5.8,57184
68,The Boy,10000000,35819556,68220952,104040508,94040508,en,7.009,2015-08-14,5.6,79,2015,105.0,"Drama,Horror,Thriller",5.4,4251
70,"Everything, Everything",10000000,34121140,61603136,95724276,85724276,en,13.998,2017-05-19,7.2,2447,2017,96.0,"Drama,Romance",6.4,26811
71,Devil,10000000,33679655,63354114,97033769,87033769,en,10.203,2010-09-17,5.9,1516,2010,80.0,"Horror,Mystery,Thriller",6.2,122080
73,The Second Best Exotic Marigold Hotel,10000000,33078266,90384306,123462572,113462572,en,7.731,2015-03-06,6.4,420,2015,122.0,"Comedy,Drama",6.6,28931
75,How to Be a Latin Lover,10000000,32149404,62556228,94705632,84705632,en,11.0,2017-04-28,6.3,197,2017,115.0,"Comedy,Drama",5.9,11747
80,Slender Man,10000000,30564825,51723644,82288469,72288469,en,16.999,2018-08-10,4.0,712,2018,93.0,"Horror,Mystery,Thriller",3.2,19650
85,When the Bough Breaks,10000000,29747603,30768449,60516052,50516052,en,8.062,2016-09-09,5.3,150,2016,107.0,"Crime,Drama,Horror",5.1,4729
91,Sinister 2,10000000,27740955,54104225,81845180,71845180,en,9.916,2015-08-21,5.8,1142,2015,97.0,"Horror,Mystery,Thriller",5.3,41782
92,The Forest,10000000,26594261,40749230,67343491,57343491,en,1.125,2011-04-14,2.5,1,2011,98.0,"Horror,Thriller",3.5,135
96,Sparkle,10000000,24397469,24660323,49057792,39057792,en,1.715,2010-09-07,7.0,7,2012,116.0,"Drama,Music",5.7,5643
97,Kevin Hart: What Now?,10000000,23591043,23591043,47182086,37182086,en,7.786,2016-10-14,6.5,159,2016,96.0,"Comedy,Documentary",5.9,8134
98,Mud,10000000,21590086,31556959,53147045,43147045,en,12.507,2013-05-10,7.0,1592,2012,130.0,Drama,7.4,156786
99,Skyline,10000000,21416355,68264973,89681328,79681328,en,8.847,2010-11-12,4.8,833,2010,92.0,"Action,Sci-Fi,Thriller",4.4,83710
100,The Disaster Artist,10000000,21120616,28717667,49838283,39838283,en,13.27,2017-12-01,7.2,1895,2017,104.0,"Biography,Comedy,Drama",7.4,111737
1,Blair Witch,10000000,20777061,38985577,59762638,49762638,en,9.772,2016-09-16,5.0,1094,2016,89.0,"Horror,Mystery,Thriller",5.0,36867
7,Paranormal Activity: The Ghost Dimension,10000000,18297124,77959374,96256498,86256498,en,8.157,2015-10-23,5.2,774,2015,88.0,"Horror,Mystery,Thriller",4.6,22361
14,The Perfect Man,10000000,16535005,19535005,36070010,26070010,en,0.655,2011-06-28,8.0,2,2011,90.0,"Drama,Romance",6.2,25
17,The Birth of a Nation,10000000,15861566,16891011,32752577,22752577,en,8.152,2016-10-07,6.5,328,2016,120.0,"Biography,Drama,History",6.4,18442
22,My Week with Marilyn,10000000,14597405,34240572,48837977,38837977,en,12.081,2011-11-23,6.7,741,2011,99.0,"Biography,Drama",7.0,79337
23,Big Eyes,10000000,14482031,27317872,41799903,31799903,en,12.017,2014-12-25,7.0,2153,2014,106.0,"Biography,Crime,Drama",7.0,77447
28,The Gift,10000000,12008642,44567606,56576248,46576248,en,1.304,2010-04-08,6.6,7,2010,,Drama,7.8,12
39,Movie 43,10000000,8840453,31164747,40005200,30005200,en,12.813,2013-01-25,4.4,1332,2013,94.0,Comedy,4.3,92980
40,Can You Ever Forgive Me?,10000000,8803865,11752387,20556252,10556252,en,17.604,2018-10-19,6.9,450,2018,106.0,"Biography,Comedy,Crime",7.2,29473
42,MacGruber,10000000,8525600,8629895,17155495,7155495,en,7.666,2010-05-21,5.3,270,2010,90.0,"Action,Comedy,Romance",5.5,39782
44,Bad Words,10000000,7779614,7843145,15622759,5622759,en,9.516,2014-03-14,6.4,451,2013,89.0,"Comedy,Drama",6.7,44061
45,While We're Young,10000000,7582065,17503828,25085893,15085893,en,8.022,2015-04-17,5.9,609,2014,97.0,"Comedy,Drama,Mystery",6.3,41327
47,Bones,10000000,7316658,8378853,15695511,5695511,en,1.4,2010-03-31,8.0,4,2010,88.0,Drama,6.6,347
48,Seeking a Friend for the End of the World,10000000,7078738,11766959,18845697,8845697,en,8.092,2012-06-22,6.4,1108,2012,101.0,"Adventure,Comedy,Drama",6.7,102047
50,Shut In,10000000,6900335,11360665,18261000,8261000,en,10.535,2016-11-11,5.2,374,2016,91.0,"Drama,Mystery,Thriller",4.7,11030
51,Cedar Rapids,10000000,6861102,7862131,14723233,4723233,en,7.694,2011-02-11,6.0,206,2011,87.0,Comedy,6.3,34759
52,The Collection,10000000,6810754,8890094,15700848,5700848,en,9.059,2012-09-21,6.1,465,2012,82.0,"Action,Horror,Thriller",6.1,42256
59,Danny Collins,10000000,5637066,8465845,14102911,4102911,en,8.933,2015-03-20,6.7,260,2015,106.0,"Biography,Comedy,Drama",7.0,27435
64,Gotti,10000000,4286367,6089100,10375467,375467,en,10.034,2018-06-15,5.2,231,2018,112.0,"Biography,Crime,Drama",4.8,10358
65,"Jeff, Who Lives at Home",10000000,4269426,4708127,8977553,-1022447,en,8.821,2011-09-13,6.2,320,2011,83.0,"Comedy,Drama",6.5,60070
66,Denial,10000000,4073448,9263940,13337388,3337388,en,9.267,2016-09-30,6.7,349,2016,109.0,"Biography,Drama",6.7,16593
67,The Man Who Knew Infinity,10000000,3877922,12382122,16260044,6260044,en,8.76,2016-04-29,7.2,699,2015,108.0,"Biography,Drama",7.2,43575
68,Max Steel,10000000,3818664,4563080,8381744,-1618256,en,8.88,2016-10-14,5.2,383,2016,92.0,"Action,Adventure,Family",4.6,16788
72,Romeo Is Bleeding,10000000,3275585,3275585,6551170,-3448830,en,2.087,2017-07-19,7.5,4,2015,93.0,"Biography,Documentary,Drama",8.1,84
74,Rosewater,10000000,3128941,3185717,6314658,-3685342,en,9.019,2014-11-07,6.7,121,2014,103.0,"Biography,Drama",6.6,9836
78,Bucky Larson: Born to Be a Star,10000000,2529395,2529395,5058790,-4941210,en,7.109,2011-09-09,4.2,79,2011,97.0,Comedy,3.3,10648
81,The Iceman,10000000,1930282,3623609,5553891,-4446109,en,11.248,2012-09-01,6.5,562,2012,106.0,"Biography,Crime,Drama",6.9,65571
82,Testament of Youth,10000000,1822250,6646669,8468919,-1531081,en,9.251,2015-06-04,7.4,486,2014,129.0,"Biography,Drama,History",7.3,23632
83,Free Fire,10000000,1799322,3793739,5593061,-4406939,en,12.116,2017-04-21,6.3,540,2016,91.0,"Action,Comedy,Crime",6.4,35954
84,A Better Life,10000000,1759252,1884251,3643503,-6356497,en,5.885,2011-06-24,7.1,97,2011,98.0,"Drama,Romance",7.2,14602
86,Gun Shy,10000000,1638202,1638202,3276404,-6723596,en,9.329,2017-09-08,4.8,68,2017,92.0,"Action,Adventure,Comedy",4.1,2216
88,The Joneses,10000000,1475746,3541565,5017311,-4982689,en,6.424,2010-04-16,6.2,312,2011,117.0,"Comedy,Drama",6.9,87
90,Killer Joe,10000000,1291645,4659110,5950755,-4049245,en,13.742,2012-07-27,6.5,703,2011,102.0,"Crime,Drama,Thriller",6.7,67842
91,Churchill,10000000,1279681,7582196,8861877,-1138123,en,7.692,2017-06-02,6.1,150,2017,105.0,"Biography,Drama,History",6.3,12047
93,50 to 1,10000000,1069454,1069454,2138908,-7861092,en,2.852,2014-03-21,6.2,25,2014,110.0,Drama,6.6,1739
99,Coriolanus,10000000,749641,2179623,2929264,-7070736,en,8.016,2012-01-19,6.0,215,2011,123.0,"Drama,Thriller,War",6.1,29654
100,Parkland,10000000,641439,1616353,2257792,-7742208,en,6.056,2013-10-04,6.1,206,2013,93.0,"Drama,History,Mystery",6.4,14036
12,Welcome to the Rileys,10000000,152857,355919,508776,-9491224,en,8.348,2010-10-29,6.5,241,2010,110.0,Drama,7.0,22210
13,Kicks,10000000,150191,150191,300382,-9699618,en,4.002,2016-09-09,6.6,50,2016,80.0,"Adventure,Drama",6.3,3789
15,High School,10000000,139034,248133,387167,-9612833,en,5.762,2010-06-03,5.8,68,2010,99.0,Comedy,5.8,7060
20,Blood Done Sign My Name,10000000,109383,109383,218766,-9781234,en,1.346,2010-02-01,6.0,5,2010,128.0,Drama,6.6,494
24,Elsa & Fred,10000000,67657,197901,265558,-9734442,en,6.241,2014-03-07,6.2,48,2014,93.0,"Comedy,Drama,Romance",6.5,2711
27,Strangerland,10000000,17472,161097,178569,-9821431,en,5.91,2015-07-10,5.2,135,2015,112.0,"Drama,Mystery,Thriller",5.2,7999
32,Barbecue,10000000,388,247565,247953,-9752047,fr,7.874,2014-09-14,5.8,383,2014,98.0,Comedy,6.1,2301
33,The Reef,10000000,0,15037867,15037867,5037867,en,5.173,2010-05-15,5.6,264,2010,94.0,"Adventure,Drama,Horror",5.8,15194
35,American Heist,10000000,0,2341218,2341218,-7658782,en,7.271,2015-07-14,4.6,213,2014,94.0,"Action,Crime,Drama",5.1,15547
36,It's a Wonderful Afterlife,10000000,0,1642939,1642939,-8357061,en,1.332,2010-10-08,4.6,12,2010,100.0,"Comedy,Drama,Fantasy",5.4,1361
39,Plastic,10000000,0,575371,575371,-9424629,en,0.6,2010-10-31,6.5,1,2011,80.0,Horror,6.2,91
43,Good Intentions,10000000,0,0,0,-10000000,en,1.179,2010-03-09,5.1,7,2010,84.0,Comedy,5.2,605
45,Detention,10000000,0,0,0,-10000000,en,2.377,2010-01-16,3.5,15,2010,81.0,"Horror,Thriller",3.0,889
47,Into the Grizzly Maze,10000000,0,0,0,-10000000,en,7.133,2015-06-26,5.3,121,2015,94.0,"Action,Adventure,Drama",5.3,7006
48,Friend Request,9900000,3759078,11310835,15069913,5169913,en,2.107,2013-05-05,5.5,43,2013,91.0,Thriller,4.0,116
51,Amour,9700000,6738954,36787044,43525998,33825998,fr,10.705,2012-12-19,7.7,746,2012,127.0,"Drama,Romance",7.9,84960
56,Dangal,9500000,12391761,294654618,307046379,297546379,hi,10.022,2016-12-21,8.1,358,2016,161.0,"Action,Biography,Drama",8.5,123638
57,The Runaways,9500000,3573673,5278632,8852305,-647695,en,8.19,2010-03-19,6.4,448,2010,106.0,"Biography,Drama,Music",6.6,43792
59,Re-Kill,9500000,0,0,0,-9500000,en,4.191,2015-10-16,4.8,47,2015,88.0,"Action,Horror",5.0,2328
62,Melancholia,9400000,3030848,21817298,24848146,15448146,da,11.123,2011-11-11,7.1,1642,2011,135.0,"Drama,Sci-Fi",7.2,153434
64,Jab Tak Hai Jaan,9200000,3047539,5806666,8854205,-345795,hi,7.701,2012-11-13,6.9,107,2012,176.0,"Drama,Romance",6.8,48364
66,Kites,9200000,1685269,17155193,18840462,9640462,hi,6.058,2010-05-21,5.8,67,2010,123.0,"Action,Drama,Romance",6.1,11353
71,The Purge: Anarchy,9000000,71562550,111534881,183097431,174097431,en,28.424,2014-07-18,6.6,3754,2014,103.0,"Action,Horror,Sci-Fi",6.5,126203
75,Ouija: Origin of Evil,9000000,35144505,81831866,116976371,107976371,en,11.823,2016-10-21,6.0,1416,2016,99.0,"Drama,Horror,Mystery",6.1,47099
80,Black or White,9000000,21571189,21971021,43542210,34542210,en,8.05,2015-01-30,6.8,193,2014,121.0,Drama,6.6,10659
86,The Edge of Seventeen,9000000,14431633,19096003,33527636,24527636,en,11.546,2016-11-18,7.2,2224,2016,104.0,"Comedy,Drama",7.3,87602
87,Jackie,9000000,13960394,36588512,50548906,41548906,en,8.819,2016-12-02,6.4,1420,2016,100.0,"Biography,Drama,History",6.7,66008
92,Loving,9000000,7710234,12898064,20608298,11608298,en,8.506,2016-11-04,6.7,529,2012,105.0,"Drama,Romance",7.1,257
1,Beautiful,9000000,3134509,3134509,6269018,-2730982,en,0.879,2014-12-11,8.0,1,2011,120.0,"Biography,Drama,Family",7.5,751
3,The Sapphires,9000000,2450867,20395040,22845907,13845907,en,6.16,2013-03-22,6.7,97,2012,103.0,"Biography,Comedy,Drama",7.0,12143
4,Greater,9000000,2000093,2000093,4000186,-4999814,en,1.891,2016-08-26,7.3,37,2016,130.0,"Biography,Family,Sport",7.2,3438
5,Destroyer,9000000,1533324,3681096,5214420,-3785580,en,17.815,2018-12-25,5.9,176,2018,121.0,"Action,Crime,Drama",6.2,13683
19,Skin Trade,9000000,1242,1242,2484,-8997516,en,9.362,2014-11-07,5.6,96,2010,78.0,Documentary,8.8,31
20,Beneath Hill 60,9000000,0,3440939,3440939,-5559061,en,6.067,2011-06-28,7.0,66,2010,122.0,"Drama,History,War",7.1,6903
24,Polisse,8900000,176988,22744132,22921120,14021120,fr,7.682,2011-11-11,7.8,670,2011,127.0,"Crime,Drama",7.3,12506
30,Manchester by the Sea,8500000,47695371,77733867,125429238,116929238,en,16.638,2016-11-18,7.5,3176,2016,137.0,Drama,7.8,214557
34,Nightcrawler,8500000,32381218,50334418,82715636,74215636,en,25.597,2014-10-31,7.7,5860,2014,117.0,"Crime,Drama,Thriller",7.9,404476
36,Dragon Ball Super: Broly,8500000,30376755,122747755,153124510,144624510,ja,6.868,2019-01-16,7.4,721,2018,100.0,"Action,Adventure,Animation",8.0,16465
38,Baggage Claim,8500000,21569509,22885836,44455345,35955345,en,8.666,2013-09-27,5.4,127,2013,96.0,Comedy,5.1,8296
39,Middle School: The Worst Years of My Life,8500000,20007149,23311293,43318442,34818442,en,8.479,2016-10-07,7.0,190,2016,92.0,"Comedy,Family",6.1,6413
47,The Rover,8500000,1109199,3180252,4289451,-4210549,en,13.528,2014-07-18,6.2,435,2014,103.0,"Action,Crime,Drama",6.4,40576
55,Limbo,8300000,2160710,2598224,4758934,-3541066,en,0.6,2015-04-12,7.7,3,2010,105.0,Drama,6.0,457
67,Easy A,8000000,58401464,76200721,134602185,126602185,en,14.69,2010-09-17,6.8,4168,2010,92.0,"Comedy,Drama,Romance",7.1,330125
73,50/50,8000000,35016118,41334735,76350853,68350853,en,12.451,2011-09-30,7.1,2111,2011,100.0,"Comedy,Drama,Romance",7.7,300475
75,A Walk in the Woods,8000000,29499394,37119358,66618752,58618752,en,6.935,2015-09-02,5.9,402,2015,104.0,"Adventure,Biography,Comedy",6.3,22033
78,That Awkward Moment,8000000,26068955,53068955,79137910,71137910,en,8.649,2014-01-31,6.1,1759,2014,94.0,"Comedy,Romance",6.2,92148
79,Shutter,8000000,25928550,47782426,73710976,65710976,en,0.6,2015-06-02,6.0,1,2012,133.0,Thriller,7.7,943
82,Much Ado About Nothing,8000000,22549338,22549338,45098676,37098676,en,5.952,2013-06-07,7.2,165,2010,68.0,"Comedy,Drama,Romance",4.5,8
88,Enough Said,8000000,17550872,25621449,43172321,35172321,en,8.722,2013-09-18,6.7,464,2013,93.0,"Comedy,Drama,Romance",7.0,55698
91,Begin Again,8000000,16170632,68838736,85009368,77009368,en,10.828,2014-07-11,7.2,2089,2013,68.0,"Drama,Family",7.0,57
97,Prom,8000000,10130219,10763183,20893402,12893402,en,6.911,2011-04-29,6.0,276,2011,104.0,"Comedy,Drama,Family",5.4,14279
100,Me and Earl and the Dying Girl,8000000,6758416,9266180,16024596,8024596,en,8.677,2015-06-12,7.6,1570,2015,105.0,"Comedy,Drama,Romance",7.8,112627
1,It's Kind of a Funny Story,8000000,6363628,6632950,12996578,4996578,en,10.01,2010-10-08,7.0,1324,2010,101.0,"Comedy,Drama,Romance",7.1,125583
5,Morgan,8000000,3915251,7298786,11214037,3214037,en,1.111,2012-01-07,6.7,12,2012,89.0,"Drama,Romance",6.8,1232
6,Anomalisa,8000000,3759286,5706168,9465454,1465454,en,10.285,2015-12-30,7.1,927,2015,90.0,"Animation,Comedy,Drama",7.3,58010
8,Another Year,8000000,3205706,20005613,23211319,15211319,en,9.394,2010-12-29,7.0,150,2010,129.0,"Comedy,Drama",7.3,26273
13,Lean on Pete,8000000,1163056,2455027,3618083,-4381917,en,9.307,2018-04-06,6.9,133,2017,121.0,"Adventure,Drama",7.2,8607
14,Made in Dagenham,8000000,1095369,15644196,16739565,8739565,en,7.275,2010-11-19,6.6,150,2010,113.0,"Biography,Comedy,Drama",7.2,13121
16,El Chicano,8000000,700261,700261,1400522,-6599478,en,5.274,2019-05-03,9.0,1,2018,108.0,Drama,5.7,290
24,London Fields,8000000,252676,433732,686408,-7313592,en,8.557,2018-10-26,5.3,59,2018,118.0,"Crime,Mystery,Thriller",4.3,2871
25,Restless,8000000,163753,2772511,2936264,-5063736,en,7.268,2011-09-16,6.4,258,2011,91.0,"Drama,Romance",6.8,16736
28,Wild Target,8000000,109338,5314194,5423532,-2576468,en,9.355,2010-10-29,6.4,356,2010,98.0,"Action,Comedy,Crime",6.8,33915
30,Wuthering Heights,8000000,100915,2721534,2822449,-5177551,en,7.61,2012-04-09,6.1,115,2011,129.0,"Drama,Romance",6.1,8549
31,A Street Cat Named Bob,8000000,82703,17382693,17465396,9465396,en,7.12,2016-11-18,7.5,500,2016,103.0,"Biography,Comedy,Drama",7.4,23204
33,Aloft,8000000,53086,237688,290774,-7709226,en,4.944,2015-05-22,5.5,61,2014,112.0,Drama,5.3,3001
42,Swelter,8000000,0,44197,44197,-7955803,en,5.232,2014-04-20,5.1,44,2014,96.0,"Action,Crime,Drama",4.6,2536
47,Code of Honor,8000000,0,0,0,-8000000,en,4.408,2016-05-06,4.2,36,2016,106.0,"Action,Crime,Thriller",4.2,1961
53,Driving Miss Daisy,7500000,106593296,106593296,213186592,205686592,en,0.6,2014-06-04,6.7,5,2014,100.0,"Comedy,Drama",8.2,122
67,Albert Nobbs,7500000,3014696,8539003,11553699,4053699,en,6.277,2011-12-21,6.3,227,2011,113.0,"Drama,Romance",6.7,22213
68,The Neon Demon,7500000,1333124,3559803,4892927,-2607073,en,11.787,2016-06-14,6.6,2005,2016,117.0,"Horror,Thriller",6.2,72359
74,Black November,7500000,0,32572,32572,-7467428,en,1.366,2012-12-07,5.9,5,2012,95.0,"Action,Crime,Drama",5.4,489
76,Pound of Flesh,7500000,0,0,0,-7500000,en,6.921,2015-05-07,5.4,95,2010,104.0,"Crime,Drama,Thriller",3.2,267
77,The Bye Bye Man,7400000,22395806,31187727,53583533,46183533,en,9.847,2017-01-13,5.1,678,2017,96.0,"Drama,Fantasy,Horror",4.3,17743
85,3,7200000,59774,295492,355266,-6844734,en,1.816,2018-08-07,6.0,2,2010,119.0,"Comedy,Drama,Romance",6.7,4722
88,Magic Mike,7000000,113721571,170549753,284271324,277271324,en,13.7,2012-06-29,6.1,1850,2012,110.0,"Comedy,Drama",6.1,123955
90,I Can Only Imagine,7000000,83482352,85604221,169086573,162086573,en,9.7,2018-03-16,7.6,155,2018,110.0,"Biography,Drama,Family",7.4,11439
93,Jumping the Broom,7000000,37295394,38158601,75453995,68453995,en,8.477,2011-05-06,6.0,103,2011,112.0,"Comedy,Drama",5.7,9089
4,Gifted,7000000,24801212,36964656,61765868,54765868,en,16.745,2017-04-12,7.9,2035,2018,,Documentary,7.0,7
6,Kingdom Come,7000000,23247539,23393939,46641478,39641478,en,1.244,2011-01-01,8.0,1,2011,87.0,"Documentary,Drama",7.6,123
8,Action Jackson,7000000,20257000,20257000,40514000,33514000,en,6.744,1988-02-12,5.2,81,2014,144.0,"Action,Thriller",3.3,2862
9,Breathless,7000000,19910002,19910002,39820004,32820004,en,4.236,2012-01-04,5.4,18,2012,92.0,"Comedy,Thriller",5.1,1238
11,Dope,7000000,17506470,18190831,35697301,28697301,en,9.246,2015-06-19,7.2,954,2015,103.0,"Comedy,Crime,Drama",7.2,76557
14,Devil's Due,7000000,15821461,36146087,51967548,44967548,en,5.893,2014-01-17,4.5,303,2014,89.0,"Horror,Mystery,Thriller",4.1,15502
16,Beyond the Lights,7000000,14618727,14618727,29237454,22237454,en,7.717,2014-11-14,7.0,238,2014,116.0,"Drama,Music,Romance",6.9,14122
27,Cyrus,7000000,7468936,10062896,17531832,10531832,en,7.735,2010-06-18,6.0,201,2010,87.0,"Crime,Horror,Mystery",4.7,944
42,Somewhere,7000000,1785645,17023121,18808766,11808766,en,7.596,2010-12-22,6.1,376,2010,97.0,"Comedy,Drama",6.3,40250
43,We Need to Talk About Kevin,7000000,1738692,10765283,12503975,5503975,en,11.964,2011-12-09,7.6,1306,2011,112.0,"Drama,Mystery,Thriller",7.5,123619
45,The Christmas Candle,7000000,1632000,1933829,3565829,-3434171,en,1.4,2013-11-22,6.0,15,2013,100.0,"Drama,Family",6.2,1538
51,Freeheld,7000000,546201,1732228,2278429,-4721571,en,7.313,2015-10-02,7.3,360,2015,103.0,"Biography,Drama,Romance",6.5,10534
52,Dom Hemingway,7000000,523511,1857458,2380969,-4619031,en,7.254,2014-04-03,5.8,302,2013,93.0,"Comedy,Crime,Drama",6.2,24557
53,The Extra Man,7000000,453377,492108,945485,-6054515,en,5.056,2010-08-01,5.9,46,2010,108.0,Comedy,5.9,4580
54,Hesher,7000000,382946,382946,765892,-6234108,en,7.14,2010-01-22,7.0,335,2010,106.0,"Comedy,Crime,Drama",7.0,48483
66,Twixt,7000000,0,1268346,1268346,-5731654,en,6.12,2012-08-10,5.0,132,2011,88.0,"Comedy,Fantasy,Horror",4.8,9774
67,Criminal Activities,7000000,0,386744,386744,-6613256,en,7.914,2015-11-20,5.9,166,2015,94.0,"Crime,Drama,Thriller",5.8,7739
73,House at the End of the Street,6900000,31611916,44103982,75715898,68815898,en,8.72,2012-09-21,5.8,1033,2012,101.0,"Drama,Horror,Thriller",5.6,66303
76,Incendies,6800000,6857096,16038343,22895439,16095439,fr,8.973,2010-09-04,8.1,1034,2010,131.0,"Drama,Mystery,War",8.3,124156
84,Annabelle,6500000,84273813,256862920,341136733,334636733,en,13.989,2014-10-03,5.6,3357,2014,99.0,"Horror,Mystery,Thriller",5.4,122039
95,Same Kind of Different as Me,6500000,6423605,6423605,12847210,6347210,en,8.756,2017-10-20,6.8,103,2017,119.0,"Biography,Drama",6.5,4319
97,Shame,6500000,4002293,20412841,24415134,17915134,en,13.152,2011-12-02,7.0,1607,2011,101.0,Drama,7.2,171353
99,The East,6500000,2274649,3027956,5302605,-1197395,en,8.044,2013-05-31,6.6,438,2013,116.0,"Adventure,Drama,Thriller",6.8,46804
1,The Messenger,6500000,1109660,1744952,2854612,-3645388,en,0.6,2015-12-04,8.0,2,2012,74.0,Drama,8.0,43
4,Tracker,6500000,0,3149,3149,-6496851,en,3.581,2010-09-12,6.7,29,2010,102.0,"Action,Adventure,Drama",6.5,3460
19,Breaking In,6000000,46840590,51411620,98252210,92252210,en,0.6,2014-01-01,2.5,2,2018,88.0,"Action,Crime,Drama",5.4,10154
37,The Possession of Hannah Grace,6000000,14836174,42785387,57621561,51621561,en,20.263,2018-11-30,5.1,393,2018,86.0,"Horror,Mystery,Thriller",5.2,11629
46,The Words,6000000,11494838,16369708,27864546,21864546,en,7.201,2012-09-07,6.6,628,2012,102.0,"Drama,Mystery,Romance",7.1,70308
47,The Lady in the Van,6000000,10021175,42320503,52341678,46341678,en,9.269,2015-12-04,6.3,393,2015,104.0,"Biography,Comedy,Drama",6.7,23105
48,Bernie,6000000,9204489,10106975,19311464,13311464,en,7.518,2012-04-27,6.6,503,2011,99.0,"Biography,Comedy,Crime",6.8,53765
54,The Guard,6000000,5359774,21197454,26557228,20557228,en,10.177,2011-07-29,6.9,563,2011,96.0,"Comedy,Crime,Thriller",7.3,75183
61,Wish I Was Here,6000000,3591299,6591365,10182664,4182664,en,7.845,2014-01-18,6.6,440,2014,106.0,"Comedy,Drama",6.7,34907
63,Veronica Mars,6000000,3322127,3485383,6807510,807510,en,7.821,2014-03-14,6.7,699,2014,107.0,"Crime,Drama,Mystery",6.8,46751
70,Snow Flower and the Secret Fan,6000000,1348205,11348205,12696410,6696410,en,4.519,2011-07-15,5.9,39,2011,104.0,"Drama,History",6.1,3429
71,Mandy,6000000,1214525,1427656,2642181,-3357819,en,0.6,2016-01-24,3.5,2,2016,113.0,"Drama,Thriller",4.1,39
76,The 5th Quarter,6000000,408159,408159,816318,-5183682,en,2.142,2011-03-25,4.7,15,2010,90.0,"Biography,Drama,Sport",5.7,1379
83,Deadfall,6000000,66351,1673635,1739986,-4260014,en,9.491,2012-12-07,5.9,357,2012,95.0,"Crime,Drama,Thriller",6.3,36491
84,Julia,6000000,65108,1365108,1430216,-4569784,en,0.627,2013-10-10,2.0,1,2014,95.0,"Horror,Thriller",4.6,1523
87,Song One,6000000,32251,437089,469340,-5530660,en,6.206,2015-01-23,5.6,126,2014,86.0,"Drama,Music",5.8,8559
91,Icarus,6000000,0,0,0,-6000000,en,5.002,2010-09-10,5.2,42,2017,120.0,"Documentary,Sport,Thriller",7.9,28979
94,Freaky Deaky,6000000,0,0,0,-6000000,en,4.476,2012-04-22,5.1,28,2012,90.0,"Comedy,Crime,Thriller",6.1,6088
95,The Hit List,6000000,0,0,0,-6000000,en,6.241,2011-04-03,5.4,116,2011,90.0,"Action,Thriller",5.4,11081
97,Emma,5900000,22231658,37831658,60063316,54163316,en,0.6,2014-11-24,10.0,1,2016,70.0,Thriller,4.7,133
11,Standing Ovation,5600000,531806,531806,1063612,-4536388,en,1.224,2010-07-16,4.3,12,2010,105.0,Musical,3.3,658
12,Khiladi 786,5600000,385422,14683763,15069185,9469185,en,1.824,2012-12-07,4.7,16,2012,141.0,"Action,Comedy",4.4,5648
18,Don Jon,5500000,24477704,41268579,65746283,60246283,en,12.78,2013-09-27,5.9,2709,2013,90.0,"Comedy,Drama,Romance",6.6,216350
20,Hell Fest,5500000,11107431,18119231,29226662,23726662,en,12.955,2018-09-28,5.5,273,2018,89.0,Horror,5.5,8662
23,Iris,5500000,5580479,5580479,11160958,5660958,en,5.445,2014-10-09,7.6,71,2011,85.0,"Drama,Family,History",5.8,123
26,Wonderland,5500000,1060512,1060512,2121024,-3378976,en,0.6,2014-10-14,3.3,3,2011,80.0,"Fantasy,Horror,Sci-Fi",5.0,159
29,Le Havre,5500000,611709,13480196,14091905,8591905,fr,5.973,2011-10-21,6.9,169,2011,93.0,"Comedy,Drama",7.2,18490
31,Salvation Boulevard,5500000,28468,28468,56936,-5443064,en,6.507,2011-07-15,5.4,38,2011,96.0,"Action,Comedy,Drama",5.3,4220
33,Miss Julie,5500000,0,863895,863895,-4636105,en,7.423,2014-10-09,5.8,77,2013,85.0,"Drama,Romance",4.1,116
34,Animals,5500000,0,0,0,-5500000,en,2.232,2014-05-15,6.1,14,2012,94.0,"Drama,Fantasy",6.2,758
38,Grabbers,5300000,0,440821,440821,-4859179,en,7.117,2013-07-19,6.1,202,2012,94.0,"Comedy,Horror,Sci-Fi",6.3,15727
44,Wilson,5200000,2000000,2000000,4000000,-1200000,en,6.97,2017-03-24,5.8,195,2017,94.0,"Comedy,Drama",5.8,8985
46,Dum Maaro Dum,5200000,564489,11633427,12197916,6997916,hi,1.491,2011-04-22,5.4,16,2011,128.0,"Action,Crime,Drama",6.2,3616
49,Get Out,5000000,176040665,255367951,431408616,426408616,en,0.834,2010-02-01,5.5,8,2017,104.0,"Horror,Mystery,Thriller",7.7,400474
50,Split,5000000,138141585,278964806,417106391,412106391,en,0.906,2012-05-24,5.3,2,2016,90.0,"Comedy,Romance,Sport",2.9,557
51,Paranormal Activity 3,5000000,104028807,207039844,311068651,306068651,en,9.669,2011-10-21,5.9,1197,2011,83.0,"Horror,Mystery,Thriller",5.8,85689
54,10 Cloverfield Lane,5000000,72082999,108286422,180369421,175369421,en,17.892,2016-03-11,6.9,4629,2016,103.0,"Drama,Horror,Mystery",7.2,260383
55,Lights Out,5000000,67268835,148806510,216075345,211075345,en,12.408,2016-07-22,6.3,2220,2010,,Drama,6.6,10
56,The Visit,5000000,65206105,98677816,163883921,158883921,en,10.196,2015-09-11,6.2,2634,2010,90.0,"Comedy,Drama,Romance",8.3,7
58,Happy Death Day,5000000,55683845,125010260,180694105,175694105,en,21.23,2017-10-13,6.6,3211,2017,96.0,"Horror,Mystery,Thriller",6.5,87132
59,Paranormal Activity 4,5000000,53900335,142817992,196718327,191718327,en,8.965,2012-10-19,5.4,1026,2012,88.0,"Horror,Mystery,Thriller",4.6,58408
60,Ouija,5000000,50856010,103300632,154156642,149156642,en,15.389,2014-10-24,5.1,1670,2014,89.0,"Horror,Mystery,Thriller",4.5,44054
64,The Big Sick,5000000,42872467,53972860,96845327,91845327,en,12.322,2017-06-23,7.4,1302,2017,120.0,"Comedy,Drama,Romance",7.6,104008
69,Monster,5000000,34469210,64240813,98710023,93710023,en,0.6,2010-01-01,5.0,1,2010,85.0,"Action,Adventure,Comedy",4.8,12
70,Paranormal Activity: The Marked Ones,5000000,32462372,90904854,123367226,118367226,en,9.446,2014-01-03,5.3,752,2014,84.0,"Horror,Mystery,Thriller",5.0,37147
72,Oculus,5000000,27695246,44115496,71810742,66810742,en,10.841,2014-04-03,6.4,1747,2013,104.0,"Horror,Mystery",6.5,106906
73,Dallas Buyers Club,5000000,27298285,60611845,87910130,82910130,en,12.389,2013-11-22,7.9,4961,2013,117.0,"Biography,Drama",8.0,402462
74,No Escape,5000000,27288872,42844516,70133388,65133388,en,19.005,2015-08-26,6.8,1296,2015,103.0,"Action,Thriller",6.8,70222
76,The Lazarus Effect,5000000,25801570,38359310,64160880,59160880,en,0.6,2010-02-09,4.8,3,2015,83.0,"Horror,Mystery,Sci-Fi",5.2,37675
78,Our Idiot Brother,5000000,24814830,25861249,50676079,45676079,en,8.523,2011-08-26,6.1,527,2011,90.0,"Comedy,Drama",6.4,80738
79,The Strangers: Prey at Night,5000000,24431472,29960051,54391523,49391523,en,13.31,2018-03-09,5.4,621,2018,85.0,Horror,5.2,21614
83,The Way Way Back,5000000,21502690,26853810,48356500,43356500,en,9.977,2013-07-05,7.1,1043,2013,103.0,"Comedy,Drama",7.4,132642
84,"As Above, So Below",5000000,21222315,41824066,63046381,58046381,en,10.613,2014-08-29,6.2,1321,2014,93.0,"Adventure,Horror,Mystery",6.2,66892
90,Race,5000000,19115191,23745772,42860963,37860963,en,8.705,2016-02-19,7.2,910,2011,150.0,Drama,3.9,73
92,Still Alice,5000000,18656400,41699612,60356012,55356012,en,10.747,2014-12-05,7.5,1946,2014,101.0,Drama,7.5,116832
94,Apollo 18,5000000,17686929,26517819,44204748,39204748,en,8.384,2011-09-02,5.0,486,2011,86.0,"Horror,Mystery,Sci-Fi",5.2,51427
95,"Paul, Apostle of Christ",5000000,17547999,25529498,43077497,38077497,en,12.005,2018-03-28,7.1,98,2018,108.0,"Adventure,Biography,Drama",6.7,5662
96,Addicted,5000000,17390770,17499242,34890012,29890012,en,8.295,2014-10-10,5.3,103,2014,106.0,"Drama,Thriller",5.2,7640
3,Spring Breakers,5000000,14124286,31149251,45273537,40273537,en,10.691,2013-03-15,5.0,2495,2012,94.0,"Comedy,Crime,Drama",5.3,126504
4,It Comes at Night,5000000,13985117,19720203,33705320,28705320,en,12.337,2017-06-09,5.8,1141,2017,91.0,"Horror,Mystery",6.2,69039
12,Before I Fall,5000000,12241072,18945682,31186754,26186754,en,14.584,2017-03-03,7.0,2135,2017,98.0,"Drama,Fantasy,Mystery",6.4,39282
15,Fifty Shades of Black,5000000,11686940,22113075,33800015,28800015,en,8.784,2016-01-29,4.4,677,2016,92.0,Comedy,3.5,17189
21,The Belko Experiment,5000000,10166820,11792942,21959762,16959762,en,10.133,2016-03-17,6.1,757,2016,89.0,"Horror,Thriller",6.1,38378
22,The Perfect Match,5000000,9669521,10182050,19851571,14851571,en,6.875,2016-03-11,5.5,78,2016,96.0,"Comedy,Romance",4.9,3052
29,Fahrenheit 11/9,5000000,6352306,6653715,13006021,8006021,en,10.003,2018-09-10,7.1,142,2018,128.0,Documentary,6.7,11628
31,Sea Rex 3D: Journey to a Prehistoric World,5000000,6096582,16515203,22611785,17611785,en,2.746,2010-05-14,7.4,12,2010,41.0,Documentary,6.9,364
38,90 Minutes in Heaven,5000000,4816142,4816142,9632284,4632284,en,5.798,2015-09-11,5.3,63,2015,121.0,Drama,4.8,3105
39,Incarnate,5000000,4799774,9371036,14170810,9170810,en,7.137,2016-12-02,5.2,314,2016,91.0,"Horror,Thriller",5.3,10217
45,Table 19,5000000,3614896,4620399,8235295,3235295,en,7.551,2017-03-03,6.0,604,2017,87.0,"Comedy,Drama,Romance",5.8,22751
46,Green Room,5000000,3220371,3807503,7027874,2027874,en,9.943,2016-04-15,6.8,1314,2015,95.0,"Horror,Music,Thriller",7.0,90773
47,Thoroughbreds,5000000,3072605,3187302,6259907,1259907,en,11.241,2018-03-09,6.3,398,2017,92.0,"Comedy,Crime,Drama",6.7,25098
49,The Other Side of the Door,5000000,3000342,12905107,15905449,10905449,en,9.078,2016-03-11,5.3,470,2014,90.0,Drama,3.8,5
50,Everything Must Go,5000000,2712131,2821010,5533141,533141,en,7.493,2011-05-13,6.0,301,2010,97.0,"Comedy,Drama",6.4,45799
51,Kill the Messenger,5000000,2450846,6656705,9107551,4107551,en,10.062,2014-10-10,6.6,507,2014,112.0,"Biography,Crime,Drama",7.0,41231
52,Rabbit Hole,5000000,2229058,6205034,8434092,3434092,en,9.389,2010-12-16,6.8,292,2010,91.0,Drama,7.0,45357
53,Jem and the Holograms,5000000,2184640,2368937,4553577,-446423,en,7.942,2015-10-23,5.4,241,2015,118.0,"Adventure,Drama,Family",4.1,6683
54,Paterson,5000000,2141423,10727536,12868959,7868959,en,9.486,2016-12-28,7.1,736,2016,118.0,"Comedy,Drama,Romance",7.4,55285
64,Ain't Them Bodies Saints,5000000,391611,1075009,1466620,-3533380,en,8.166,2013-08-16,6.2,217,2013,96.0,"Crime,Drama,Romance",6.4,19464
71,Cop Car,5000000,134552,143658,278210,-4721790,en,11.414,2015-08-07,5.8,452,2015,88.0,"Crime,Thriller",6.3,27081
76,Stuck,5000000,67505,67505,135010,-4864990,en,1.282,2013-02-23,5.6,4,2012,,"Comedy,Drama",4.6,9
78,Rudderless,5000000,56001,567219,623220,-4376780,en,8.03,2014-10-17,7.4,149,2014,105.0,"Comedy,Drama,Music",7.5,16303
80,Grace,5000000,8297,8297,16594,-4983406,en,5.781,2014-10-28,4.6,78,2011,98.0,"Crime,Drama,Horror",6.5,19
81,Area 51,5000000,7556,7556,15112,-4984888,en,6.794,2015-05-15,4.4,248,2015,91.0,"Horror,Sci-Fi,Thriller",4.2,11537
84,The Cottage,5000000,0,1504960,1504960,-3495040,en,1.666,2012-12-10,4.3,14,2012,88.0,"Drama,Horror,Thriller",4.8,1016
85,Dying of the Light,5000000,0,74639,74639,-4925361,en,9.064,2014-12-04,4.6,174,2014,94.0,"Drama,Thriller",4.4,8888
86,Yoga Hosers,5000000,0,22958,22958,-4977042,en,8.05,2016-09-02,4.5,221,2016,88.0,"Action,Comedy,Fantasy",4.3,10483
90,Reach Me,5000000,0,0,0,-5000000,en,4.659,2014-03-14,5.2,48,2014,95.0,"Comedy,Crime,Drama",4.9,2304
91,Henry & Me,5000000,0,0,0,-5000000,en,0.6,2014-08-18,4.7,3,2014,67.0,"Animation,Family",6.2,132
93,Let's Kill Ward's Wife,5000000,0,0,0,-5000000,en,7.157,2014-12-23,5.6,96,2014,82.0,"Comedy,Crime",5.4,5164
1,Mommy,4900000,3498695,17536004,21034699,16134699,en,11.095,2014-08-29,8.3,1399,2014,139.0,Drama,8.1,43020
4,The Awakening,4900000,95933,6924321,7020254,2120254,en,0.6,2010-10-29,4.0,3,2010,83.0,"Horror,Thriller",2.4,141
8,Only God Forgives,4800000,775849,4494560,5270409,470409,en,10.196,2013-07-19,5.8,1396,2013,90.0,"Crime,Drama",5.7,100318
9,Take Shelter,4750000,1728953,4972016,6700969,1950969,en,11.236,2011-09-30,7.2,787,2011,121.0,"Drama,Horror,Thriller",7.4,83200
14,Without Men,4700000,0,0,0,-4700000,en,2.312,2011-06-29,4.5,13,2011,87.0,Comedy,3.3,1576
15,Treading Water,4700000,0,0,0,-4700000,en,1.39,2015-03-13,6.2,7,2013,92.0,"Comedy,Drama",6.2,515
23,Out of the Blue,4600000,728,731767,732495,-3867505,en,0.6,2013-10-01,10.0,1,2013,108.0,"Comedy,Drama",6.2,760
32,The Lobster,4500000,9196278,18019834,27216112,22716112,en,15.64,2016-05-13,6.9,2895,2015,119.0,"Comedy,Drama,Romance",7.1,182622
33,Bound,4500000,3802260,7011317,10813577,6313577,en,5.883,2015-01-09,3.5,42,2015,91.0,"Drama,Thriller",3.5,1931
46,Blackthorn,4500000,200558,1217307,1417865,-3082135,en,7.548,2011-10-07,6.7,111,2011,102.0,"Action,Adventure,Western",6.6,8553
47,Maggie,4500000,187112,1027760,1214872,-3285128,en,13.0,2015-05-08,5.3,958,2015,95.0,"Drama,Horror",5.6,38671
53,The Sweeney,4500000,26345,8000366,8026711,3526711,en,6.4,2013-03-01,5.9,142,2012,112.0,"Action,Crime,Drama",6.1,18095
54,Falcon Rising,4500000,11774,11774,23548,-4476452,en,10.059,2014-09-05,5.8,126,2014,103.0,"Action,Adventure",5.8,6955
57,Zipper,4500000,0,0,0,-4500000,en,9.373,2015-08-28,5.7,85,2015,112.0,"Drama,Thriller",5.8,6120
58,The Final Girls,4500000,0,0,0,-4500000,en,8.362,2015-10-09,6.5,619,2015,88.0,"Comedy,Drama,Fantasy",6.6,30219
64,Anna,4357373,0,1200000,1200000,-3157373,en,1.463,2017-10-17,3.1,8,2013,99.0,"Drama,Mystery,Sci-Fi",6.5,19733
69,Night of the Living Dead,4200000,5835247,5835247,11670494,7470494,en,0.6,2014-10-24,6.5,1,2014,79.0,Horror,5.3,277
71,Animal Kingdom,4200000,1044039,8078683,9122722,4922722,en,10.188,2010-08-13,6.8,399,2010,113.0,"Crime,Drama",7.3,51576
73,Cargo,4200000,0,313230,313230,-3886770,en,1.925,2011-10-21,4.4,7,2011,85.0,Drama,5.2,454
81,The Boy Next Door,4000000,36006065,53401938,89408003,85408003,en,0.6,2008-11-14,5.7,6,2015,91.0,"Horror,Thriller",4.7,34816
85,Boyhood,4000000,25379975,57273049,82653024,78653024,en,11.141,2014-07-11,7.5,3097,2014,165.0,Drama,7.9,315584
87,The Kids Are All Right,4000000,20811365,36275469,57086834,53086834,en,8.426,2010-07-09,6.6,854,2010,106.0,"Comedy,Drama,Romance",7.0,120656
89,A Haunted House 2,4000000,17329487,21206861,38536348,34536348,en,6.948,2014-04-18,5.5,597,2014,86.0,"Comedy,Fantasy",4.7,18085
90,The Last Exorcism Part II,4000000,15179303,25448707,40628010,36628010,en,7.561,2013-03-01,4.5,297,2013,88.0,"Drama,Horror,Thriller",4.0,15124
98,The Darkness,4000000,10753574,10898293,21651867,17651867,en,8.357,2016-05-13,4.8,347,2016,92.0,"Horror,Thriller",4.4,12435
18,Samsara,4000000,2672413,5966671,8639084,4639084,en,6.015,2012-08-22,8.2,276,2011,102.0,"Documentary,Music",8.5,29725
20,The Art of Getting By,4000000,1430241,1989035,3419276,-580724,en,8.695,2011-06-17,6.5,752,2011,83.0,"Drama,Romance",6.6,53682
22,Red State,4000000,1065429,1983596,3049025,-950975,en,7.816,2011-09-23,6.1,472,2011,88.0,"Action,Crime,Horror",6.2,59266
25,Holy Motors,4000000,641054,4230426,4871480,871480,fr,5.31,2012-10-17,7.0,431,2012,115.0,"Drama,Fantasy",7.1,36874
26,The Signal,4000000,600896,2665322,3266218,-733782,en,10.032,2014-06-13,5.9,901,2014,97.0,"Drama,Mystery,Sci-Fi",6.1,58407
29,The Face of Love,4000000,385069,1158877,1543946,-2456054,en,5.519,2014-03-07,6.1,68,2013,92.0,"Drama,Mystery,Romance",6.2,4710
30,Joe,4000000,373375,373375,746750,-3253250,en,8.57,2014-04-11,6.6,514,2013,117.0,"Crime,Drama",6.9,42825
38,Desert Dancer,4000000,155271,596335,751606,-3248394,en,1.508,2015-03-20,6.9,33,2014,104.0,"Biography,Drama,Music",6.2,1653
41,Manglehorn,4000000,132270,797439,929709,-3070291,en,7.661,2015-06-19,5.4,94,2014,97.0,Drama,5.6,6564
43,Trust,4000000,120016,120016,240032,-3759968,en,7.805,2011-04-01,6.6,556,2010,106.0,"Crime,Drama,Thriller",6.9,39422
47,Stake Land,4000000,33245,679482,712727,-3287273,en,8.799,2010-10-01,6.2,415,2010,98.0,"Drama,Horror,Sci-Fi",6.5,38749
51,13 Sins,4000000,9134,47552,56686,-3943314,en,10.899,2014-04-18,6.3,576,2014,93.0,"Horror,Thriller",6.3,29550
52,Another Happy Day,4000000,9120,978527,987647,-3012353,en,5.473,2011-11-18,6.1,60,2011,119.0,"Comedy,Drama",6.0,3793
53,Inescapable,4000000,4327,4327,8654,-3991346,en,6.122,2013-02-22,5.2,27,2012,93.0,"Action,Drama,Mystery",5.2,2410
56,A Lonely Place to Die,4000000,0,442550,442550,-3557450,en,9.104,2011-04-09,6.1,251,2011,99.0,"Adventure,Crime,Thriller",6.3,25547
57,Nothing,4000000,0,63180,63180,-3936820,en,0.6,2017-02-07,6.0,1,2010,84.0,"Comedy,Drama",7.0,903
64,The Veil,4000000,0,0,0,-4000000,en,9.148,2016-02-02,4.6,188,2017,93.0,"Action,Adventure,Sci-Fi",3.5,1236
67,Chain of Command,4000000,0,0,0,-4000000,en,3.767,2015-09-08,5.0,20,2015,88.0,"Action,Thriller",3.5,1189
79,Four Lions,3750000,310007,2436111,2746118,-1003882,en,9.968,2010-11-05,7.0,621,2010,97.0,"Comedy,Crime,Drama",7.3,66209
91,Truth or Dare,3500000,41411015,95127344,136538359,133038359,en,8.102,2012-08-06,5.6,194,2013,85.0,"Horror,Romance,Thriller",6.0,14
94,The Witch,3500000,25138705,40454520,65593225,62093225,en,13.493,2016-02-19,6.6,2931,2015,92.0,"Horror,Mystery",6.8,154278
95,Winchester,3500000,25091816,44378040,69469856,65969856,en,12.44,2018-02-02,5.7,884,2018,99.0,"Biography,Drama,Fantasy",5.4,24351
97,Dark Skies,3500000,17418667,27704111,45122778,41622778,en,11.582,2013-02-22,6.1,1004,2013,97.0,"Horror,Sci-Fi,Thriller",6.3,65754
98,Forever My Girl,3500000,16376066,16376066,32752132,29252132,en,15.953,2018-01-26,7.4,406,2018,108.0,"Drama,Music,Romance",6.7,10316
2,Frenzy,3500000,12600000,12600000,25200000,21700000,en,2.962,2018-08-15,3.9,9,2015,90.0,Thriller,8.1,16
11,First Reformed,3500000,3448256,3874772,7323028,3823028,en,12.943,2018-05-18,6.9,446,2017,113.0,"Drama,Mystery,Thriller",7.1,33542
13,Believe,3500000,890303,890303,1780606,-1719394,en,1.327,2013-09-27,5.9,12,2013,96.0,"Drama,Sport",5.7,695
15,American Honey,3500000,663247,2611750,3274997,-225003,en,8.778,2016-09-30,6.7,417,2016,163.0,"Adventure,Drama,Romance",7.0,31663
16,The Bronze,3500000,615816,615816,1231632,-2268368,en,8.328,2016-03-18,5.8,186,2015,100.0,"Comedy,Drama,Sport",6.0,9043
19,The Masked Saint,3500000,182695,182695,365390,-3134610,en,1.42,2016-01-08,3.5,16,2016,105.0,"Action,Biography,Crime",4.6,559
22,Time to Choose,3500000,29233,29233,58466,-3441534,en,0.753,2015-09-04,8.3,3,2015,100.0,Documentary,7.5,186
32,Dawn Patrol,3500000,0,0,0,-3500000,en,1.772,2015-06-05,5.1,15,2014,88.0,"Drama,Thriller",4.8,615
37,Margin Call,3400000,5353586,20433227,25786813,22386813,en,9.498,2011-10-21,6.8,856,2011,107.0,"Drama,Thriller",7.1,107264
40,August,3400000,12636,12636,25272,-3374728,en,2.433,2011-06-09,6.6,19,2011,99.0,"Drama,Romance",5.9,1609
43,Whiplash,3300000,13092006,38969037,52061043,48761043,en,6.298,2013-01-18,7.9,94,2014,106.0,"Drama,Music",8.5,616916
48,The Opposite Sex,3300000,0,50206,50206,-3249794,en,8.832,2014-11-08,4.1,20,2014,97.0,Comedy,4.6,821
54,Sorry to Bother You,3200000,17493096,18285560,35778656,32578656,en,15.887,2018-07-06,6.9,481,2018,111.0,"Comedy,Fantasy,Sci-Fi",7.0,40290
57,Beginners,3200000,5790894,14314407,20105301,16905301,en,10.322,2011-06-17,6.9,532,2010,105.0,"Comedy,Drama,Romance",7.2,83770
58,The Meddler,3200000,4267219,5526942,9794161,6594161,en,7.725,2016-04-22,5.8,186,2015,103.0,"Comedy,Drama,Romance",6.3,10629
60,Feast,3200000,56131,690872,747003,-2452997,en,7.51,2014-11-07,8.0,578,2014,,Horror,7.8,33
63,Antiviral,3100000,0,123407,123407,-2976593,en,6.33,2013-04-12,5.8,152,2012,108.0,"Horror,Sci-Fi,Thriller",5.7,11025
65,Paranormal Activity 2,3000000,84752907,177512032,262264939,259264939,en,8.163,2010-10-21,5.7,1342,2010,91.0,Horror,5.7,93122
66,War Room,3000000,67790117,73975239,141765356,138765356,en,7.419,2015-08-28,7.5,171,2015,120.0,Drama,6.5,11716
67,The Purge,3000000,64473115,91266581,155739696,152739696,en,24.364,2013-06-06,6.2,4797,2013,85.0,"Horror,Thriller",5.7,183549
69,Sinister,3000000,48086903,87727807,135814710,132814710,en,0.6,2011-05-03,3.8,8,2012,110.0,"Horror,Mystery,Thriller",6.8,198345
72,Coming Home,3000000,32653000,32653000,65306000,62306000,zh,5.348,2014-10-10,7.3,76,2014,86.0,"Documentary,Drama",6.9,15
89,Upgrade,3000000,11977130,16553285,28530415,25530415,en,21.413,2018-06-01,7.4,1326,2018,100.0,"Action,Sci-Fi,Thriller",7.6,104978
97,Red River,3000000,9012000,9012000,18024000,15024000,en,0.875,2011-05-05,0.0,1,2011,77.0,Horror,2.3,179
99,Before Midnight,3000000,8110621,23251930,31362551,28362551,en,11.765,2013-06-14,7.4,1039,2013,109.0,"Drama,Romance",7.9,123107
1,The Collector,3000000,7712114,10473836,18185950,15185950,en,1.4,2012-06-07,0.5,2,2012,94.0,"Action,Comedy",7.1,7
3,Let There Be Light,3000000,7233471,7241309,14474780,11474780,en,2.01,2017-10-27,6.2,23,2017,100.0,Drama,4.8,2179
10,Swiss Army Man,3000000,4210454,5837111,10047565,7047565,en,10.0,2016-06-24,6.9,1789,2016,97.0,"Adventure,Comedy,Drama",7.0,91736
14,Frances Ha,3000000,4067398,11262769,15330167,12330167,en,9.42,2013-05-17,7.4,624,2012,86.0,"Comedy,Drama,Romance",7.4,60026
15,Please Give,3000000,4033574,4570178,8603752,5603752,en,5.945,2010-01-22,6.3,81,2010,87.0,"Comedy,Drama",6.6,10652
21,Compadres,3000000,3127773,7445044,10572817,7572817,es,1.927,2016-04-22,5.1,21,2016,101.0,"Action,Comedy,Crime",4.7,876
25,Letters to God,3000000,2848587,3237452,6086039,3086039,en,4.242,2010-04-09,6.9,71,2010,110.0,"Drama,Family",6.3,4443
26,Happiness,3000000,2746453,5746453,8492906,5492906,en,0.6,2014-01-17,7.0,3,2013,80.0,"Documentary,Drama,Family",7.1,270
28,Tusk,3000000,1821983,1887554,3709537,709537,en,8.655,2014-09-19,5.3,601,2014,102.0,"Comedy,Drama,Horror",5.3,40827
29,The Wall,3000000,1803064,4495262,6298326,3298326,de,5.577,2013-06-07,6.7,61,2010,78.0,Documentary,9.2,8
31,Damsels in Distress,3000000,1007535,1324299,2331834,-668166,en,6.625,2012-04-06,5.5,103,2011,99.0,"Comedy,Drama,Romance",5.7,8794
32,Oldboy,3000000,707391,6239723,6947114,3947114,en,11.378,2013-11-27,5.9,1032,2013,104.0,"Action,Drama,Mystery",5.8,63231
33,Hobo with a Shotgun,3000000,703372,834953,1538325,-1461675,en,8.844,2011-05-06,5.9,300,2011,86.0,"Action,Comedy,Horror",6.1,41633
34,The D Train,3000000,669688,772366,1442054,-1557946,xx,0.6,2011-01-01,6.0,2,2015,101.0,"Comedy,Drama",5.0,10066
35,Bachelorette,3000000,446770,12577401,13024171,10024171,en,7.05,2012-09-06,5.4,755,2012,87.0,"Comedy,Romance",5.3,43131
38,Creature,3000000,331000,331000,662000,-2338000,en,5.121,2011-09-09,4.1,23,2011,93.0,Horror,3.7,2723
39,The Bounce Back,3000000,321910,421404,743314,-2256686,en,2.494,2016-02-26,6.1,31,2016,104.0,"Comedy,Romance",5.0,492
44,Tim and Eric's Billion Dollar Movie,3000000,201436,223652,425088,-2574912,en,4.946,2012-03-02,5.7,61,2012,93.0,Comedy,5.4,9004
49,Fort McCoy,3000000,78948,78948,157896,-2842104,en,0.669,2014-01-01,6.3,2,2011,100.0,"Drama,History,War",5.9,319
52,Before We Go,3000000,37151,483938,521089,-2478911,en,8.233,2015-05-21,6.5,985,2014,95.0,"Comedy,Drama,Romance",6.8,45181
53,The Divide,3000000,18000,156362,174362,-2825638,en,7.778,2011-03-13,5.9,302,2011,112.0,"Drama,Horror,Sci-Fi",5.8,33603
56,Demonic,3000000,0,4668109,4668109,1668109,en,6.84,2015-03-28,5.1,267,2015,83.0,"Horror,Thriller",5.3,12025
58,They Came Together,3000000,0,82780,82780,-2917220,en,7.353,2014-06-27,5.5,226,2014,83.0,"Comedy,Romance",5.5,19832
59,Open Road,3000000,0,47469,47469,-2952531,en,3.271,2013-05-21,5.1,20,2013,85.0,"Action,Drama,Thriller",5.5,1619
61,Barry Munday,3000000,0,0,0,-3000000,en,5.141,2010-03-13,6.0,37,2010,95.0,"Comedy,Drama,Romance",5.9,3846
65,AWOL-72,3000000,0,0,0,-3000000,en,4.2,2015-08-07,3.8,22,2015,82.0,"Action,Thriller",3.8,785
67,Enter the Dangerous Mind,3000000,0,0,0,-3000000,en,2.645,2013-03-11,4.8,14,2013,88.0,Thriller,5.2,915
68,Something Wicked,3000000,0,0,0,-3000000,en,2.403,2014-04-04,4.5,21,2014,95.0,"Drama,Horror,Mystery",4.8,1243
69,Point Blank,3000000,0,0,0,-3000000,fr,6.021,2011-07-29,6.6,230,2010,81.0,"Action,Crime,Drama",6.8,12706
72,Amnesiac,3000000,0,0,0,-3000000,en,6.144,2015-08-14,4.5,95,2013,90.0,"Drama,Horror,Thriller",2.3,104
73,Unnatural,3000000,0,0,0,-3000000,en,4.652,2015-10-16,4.3,22,2015,89.0,"Action,Horror,Sci-Fi",4.0,1590
74,Close Range,3000000,0,0,0,-3000000,en,6.604,2015-12-11,5.2,87,2015,80.0,"Action,Crime",5.0,3974
80,Freakonomics,2900000,101270,172867,274137,-2625863,en,5.705,2010-10-01,6.6,57,2010,93.0,Documentary,6.4,6466
81,Griff the Invisible,2900000,20778,25935,46713,-2853287,en,3.519,2011-08-19,6.0,44,2010,90.0,"Comedy,Drama,Romance",6.1,4478
93,Indivisible,2700000,3511417,3588305,7099722,4399722,en,5.599,2018-10-26,5.4,13,2017,78.0,Documentary,7.2,10
98,Diane,2660000,0,0,0,-2660000,en,3.521,2018-04-22,7.5,4,2017,82.0,"Crime,Drama,Horror",4.6,127
3,Ida,2600000,3827060,15298355,19125415,16525415,pl,7.568,2014-05-02,7.3,455,2013,82.0,Drama,7.4,46819
10,"Fat, Sick & Nearly Dead",2600000,0,0,0,-2600000,en,3.356,2010-04-16,7.2,69,2010,97.0,Documentary,7.6,8164
12,A Haunted House,2500000,40041683,59922558,99964241,97464241,en,6.909,2013-01-11,5.5,871,2013,86.0,"Comedy,Fantasy",5.1,40308
14,Kevin Hart: Let Me Explain,2500000,32244051,32327255,64571306,62071306,en,8.476,2013-07-03,6.9,142,2013,75.0,"Comedy,Documentary",6.8,7880
22,The Spectacular Now,2500000,6852971,6916951,13769922,11269922,en,13.679,2013-09-13,6.6,1801,2013,95.0,"Comedy,Drama,Romance",7.1,133887
25,Hunt for the Wilderpeople,2500000,5205471,23845533,29051004,26551004,en,12.545,2016-06-24,7.8,915,2016,101.0,"Adventure,Comedy,Drama",7.9,87532
26,Robot & Frank,2500000,3317468,4934356,8251824,5751824,en,7.485,2012-08-16,6.9,620,2012,89.0,"Comedy,Crime,Drama",7.1,59229
31,The Lost Medallion: The Adventures of Billy Stone,2500000,549632,549632,1099264,-1400736,en,2.164,2013-03-01,5.5,21,2013,97.0,"Adventure,Family,Fantasy",4.9,1502
34,Super,2500000,327716,593933,921649,-1578351,en,11.36,2011-03-31,6.6,726,2010,96.0,"Action,Comedy,Drama",6.8,70604
38,8: The Mormon Proposition,2500000,100280,100280,200560,-2299440,en,2.19,2010-01-01,6.2,11,2010,80.0,Documentary,7.0,1190
41,Underdogs,2500000,35017,1392649,1427666,-1072334,en,1.4,2013-04-06,5.5,16,2013,106.0,"Adventure,Animation,Family",6.5,8197
43,The Calling,2500000,0,0,0,-2500000,en,6.605,2014-08-05,5.7,110,2014,108.0,"Drama,Thriller",5.8,7350
45,Christmas Mail,2500000,0,0,0,-2500000,en,3.793,2010-12-01,5.4,29,2010,89.0,"Comedy,Drama,Family",5.8,1317
46,Stung,2500000,0,0,0,-2500000,en,6.573,2015-07-03,5.1,91,2015,87.0,"Action,Adventure,Comedy",5.1,4257
48,8 Days,2500000,0,0,0,-2500000,en,0.84,2014-06-15,8.0,2,2014,90.0,"Drama,Thriller",5.0,102
49,Antibirth,2500000,0,0,0,-2500000,en,5.716,2016-09-02,4.8,66,2016,94.0,Horror,4.9,2759
50,The Rise of the Krays,2500000,0,0,0,-2500000,en,3.322,2015-08-29,4.8,26,2015,110.0,"Crime,Drama",5.0,1723
60,Do You Believe?,2300000,12985600,14304931,27290531,24990531,en,5.599,2015-03-20,7.0,72,2015,120.0,Drama,6.1,6462
63,Frontera,2300000,59696,59696,119392,-2180608,en,9.723,2014-09-05,6.3,80,2014,103.0,"Drama,Thriller,Western",6.6,6861
64,Redemption Road,2300000,29384,29384,58768,-2241232,en,1.128,2011-08-26,4.7,6,2010,95.0,Drama,5.8,479
66,Eden,2300000,0,0,0,-2300000,en,6.877,2012-03-11,6.8,100,2012,98.0,"Crime,Drama",6.7,7709
79,Bully,2100000,881824,1381824,2263648,163648,en,5.877,2011-04-23,7.2,93,2011,98.0,Documentary,7.4,9597
83,Infected,2100000,0,0,0,-2100000,en,2.168,2012-10-31,2.4,8,2013,95.0,"Action,Horror,Sci-Fi",2.8,1028
87,Courageous,2000000,34522221,35185884,69708105,67708105,en,7.406,2011-09-30,7.0,128,2011,129.0,Drama,7.0,17586
94,It Follows,2000000,14674077,23250755,37924832,35924832,en,18.419,2015-03-27,6.5,3485,2014,100.0,"Horror,Mystery",6.9,182839
95,Eighth Grade,2000000,13539710,14341016,27880726,25880726,en,14.777,2018-07-13,7.4,519,2018,93.0,"Comedy,Drama",7.5,43256
97,Silent House,2000000,12739737,16610760,29350497,27350497,en,7.079,2011-01-21,5.2,184,2011,86.0,"Drama,Horror,Mystery",5.3,20831
100,Hardcore Henry,2000000,9252038,17187434,26439472,24439472,en,10.459,2016-04-06,6.2,1294,2015,96.0,"Action,Adventure,Sci-Fi",6.7,78226
8,Winter's Bone,2000000,6531503,16131551,22663054,20663054,en,9.824,2010-06-11,6.9,931,2010,100.0,"Drama,Mystery",7.2,127751
9,Meet the Mormons,2000000,6047363,6049171,12096534,10096534,es,0.6,2014-10-10,5.4,7,2014,78.0,Documentary,6.9,1897
11,The Florida Project,2000000,5904366,11295324,17199690,15199690,en,11.597,2017-10-06,7.4,1125,2017,111.0,Drama,7.6,72193
12,All Saints,2000000,5802208,5941994,11744202,9744202,en,4.042,2017-08-25,6.1,25,2017,108.0,Drama,6.0,1220
17,Inside Job,2000000,4311834,7799257,12111091,10111091,en,9.514,2010-10-08,7.8,466,2010,109.0,"Crime,Documentary",8.3,65304
20,We Are Your Friends,2000000,3591417,10153415,13744832,11744832,en,10.809,2015-08-28,6.3,1241,2015,96.0,"Drama,Music,Romance",6.2,32327
23,Captive,2000000,2583301,2791973,5375274,3375274,en,1.472,2013-05-14,3.8,7,2012,120.0,"Drama,Thriller",6.0,674
25,Hearts Beat Loud,2000000,2386254,2420962,4807216,2807216,en,13.201,2018-06-08,7.4,87,2018,97.0,"Comedy,Drama,Music",6.9,6543
26,The Resurrection of Gavin Stone,2000000,2303792,2303792,4607584,2607584,en,1.509,2017-01-20,6.7,10,2016,91.0,"Comedy,Drama,Family",6.2,1562
35,The Diary of a Teenage Girl,2000000,1477002,2279959,3756961,1756961,en,9.382,2015-08-28,6.7,460,2015,102.0,"Comedy,Drama,Romance",6.9,27003
37,Locke,2000000,1370646,2088390,3459036,1459036,en,9.128,2014-04-25,6.9,1370,2013,85.0,Drama,7.1,120703
40,Meek's Cutoff,2000000,977772,1869928,2847700,847700,en,7.309,2010-10-08,6.5,113,2010,104.0,"Drama,Western",6.6,10439
41,The Babadook,2000000,950792,7482387,8433179,6433179,en,11.502,2014-11-28,6.4,3528,2014,94.0,"Drama,Horror",6.8,171411
44,The Virginity Hit,2000000,636706,636706,1273412,-726588,en,4.834,2010-09-10,4.6,35,2010,86.0,Comedy,4.6,3696
48,Teeth,2000000,347578,2350641,2698219,698219,en,1.0,2015-01-25,7.6,5,2017,71.0,Drama,8.8,25
49,Stonewall,2000000,304602,304602,609204,-1390796,en,5.209,2015-09-25,6.2,69,2015,129.0,"Drama,History",5.1,3011
51,The Last Five Years,2000000,147299,205298,352597,-1647403,en,5.079,2015-02-13,5.9,230,2014,94.0,"Comedy,Drama,Musical",5.9,8735
57,Pump,2000000,72277,72277,144554,-1855446,en,0.779,2014-09-19,7.4,6,2014,88.0,Documentary,7.7,608
60,Lost River,2000000,45431,2009644,2055075,55075,en,7.029,2015-04-10,5.8,352,2014,95.0,"Drama,Fantasy,Mystery",5.8,15667
62,Knock Knock,2000000,36336,6328516,6364852,4364852,en,17.867,2015-10-09,5.0,1490,2015,99.0,"Drama,Thriller",4.9,68328
67,The First Time,2000000,17061,17061,34122,-1965878,en,11.25,2012-10-19,7.0,1426,2012,95.0,"Comedy,Drama,Romance",6.9,62589
69,Circle,2000000,10024,10024,20048,-1979952,en,2.587,2010-09-11,3.8,6,2010,88.0,"Horror,Thriller",3.4,610
73,Plush,2000000,3080,28864,31944,-1968056,en,0.6,2011-10-31,7.5,1,2013,99.0,"Drama,Music,Thriller",5.4,3462
74,The Ghastly Love of Johnny X,2000000,2436,2436,4872,-1995128,en,2.971,2013-04-26,6.5,9,2012,106.0,"Comedy,Fantasy,Musical",5.7,386
76,Grave Encounters,2000000,0,2151887,2151887,151887,en,8.475,2011-09-09,6.2,700,2011,92.0,Horror,6.1,48125
77,Bone Tomahawk,2000000,0,475846,475846,-1524154,en,11.891,2015-10-23,6.8,905,2015,132.0,"Adventure,Drama,Horror",7.1,70298
79,Stitches,2000000,0,63555,63555,-1936445,en,6.394,2012-10-05,5.6,138,2010,71.0,Horror,7.2,20
82,Nine Dead,2000000,0,0,0,-2000000,en,8.882,2011-03-09,5.1,125,2010,98.0,"Crime,Drama,Horror",5.5,11358
84,Rockaway,2000000,0,0,0,-2000000,en,1.115,2017-08-02,7.0,4,2017,90.0,"Adventure,Drama",6.4,528
85,Wings,2000000,0,0,0,-2000000,en,3.212,2013-08-05,3.8,12,2012,84.0,"Adventure,Animation,Comedy",3.2,561
87,Straight A's,2000000,0,0,0,-2000000,en,5.307,2013-03-19,5.3,71,2013,91.0,"Comedy,Drama",5.7,4197
89,Highway,2000000,0,0,0,-2000000,en,2.409,2012-09-09,2.7,3,2012,77.0,Comedy,3.5,183
90,Small Apartments,2000000,0,0,0,-2000000,en,5.302,2012-03-10,5.9,75,2012,96.0,"Comedy,Crime,Drama",6.1,6688
91,Coffee Town,2000000,0,0,0,-2000000,en,4.758,2013-07-09,6.7,56,2013,87.0,Comedy,6.6,4666
92,Lucky Dog,2000000,0,0,0,-2000000,en,0.628,2014-01-01,4.0,1,2012,,"Comedy,Crime",4.0,9
96,The Walking Deceased,2000000,0,0,0,-2000000,en,3.215,2015-03-20,5.0,59,2015,88.0,"Comedy,Horror",3.5,2914
98,The Curse of Downers Grove,2000000,0,0,0,-2000000,en,3.674,2015-08-21,4.7,42,2015,89.0,"Drama,Horror,Mystery",4.5,1618
99,Wind Walkers,2000000,0,0,0,-2000000,en,1.388,2015-10-16,6.0,8,2015,93.0,"Action,Horror,Thriller",3.8,234
100,The Dog Lover,2000000,0,0,0,-2000000,en,1.61,2016-07-08,5.9,11,2016,101.0,Drama,5.6,620
1,Shark Lake,2000000,0,0,0,-2000000,en,3.521,2015-10-02,3.9,31,2015,92.0,"Action,Adventure,Crime",3.5,1686
2,Buried,1987650,1044143,21270290,22314433,20326783,en,10.888,2010-09-24,6.6,1487,2010,95.0,"Drama,Mystery,Thriller",7.0,139426
8,Brotherly Love,1900000,478595,478595,957190,-942810,en,2.157,2015-04-24,6.8,53,2015,89.0,Drama,6.7,1587
9,Submarine,1900000,467602,4581937,5049539,3149539,en,7.412,2011-06-03,7.4,770,2010,97.0,"Comedy,Drama,Romance",7.3,79810
10,The Square,1900000,406216,740932,1147148,-752852,ar,5.596,2013-10-25,7.8,84,2013,108.0,"Documentary,Drama,History",8.1,7998
13,Stranded,1900000,0,285593,285593,-1614407,en,6.563,2013-07-26,3.6,73,2010,103.0,"Horror,Mystery",5.1,800
15,The Last Exorcism,1800000,41034350,70165900,111200250,109400250,en,9.35,2010-08-27,5.6,519,2010,87.0,"Drama,Horror,Thriller",5.6,45815
18,Beasts of the Southern Wild,1800000,12795746,23265132,36060878,34260878,en,7.53,2012-06-29,6.9,605,2012,93.0,"Adventure,Drama,Fantasy",7.3,77440
25,Higher Ground,1800000,841056,842693,1683749,-116251,en,4.545,2011-08-26,5.9,21,2011,109.0,Drama,6.3,2869
29,Deadline,1800000,0,0,0,-1800000,en,1.4,2012-02-15,5.5,4,2012,95.0,"Drama,Mystery,Thriller",4.8,396
31,Dysfunctional Friends,1800000,0,0,0,-1800000,en,1.392,2012-02-03,5.3,6,2012,111.0,"Comedy,Drama",5.2,760
32,Independence Daysaster,1800000,0,0,0,-1800000,en,3.562,2013-06-27,4.2,35,2013,90.0,"Action,Adventure,Sci-Fi",3.4,974
37,I Spit on Your Grave,1750000,93051,1278471,1371522,-378478,en,13.102,2010-10-08,6.3,977,2010,108.0,"Horror,Thriller",6.3,68592
42,The Lunchbox,1700000,4231500,12231500,16463000,14763000,hi,5.888,2014-02-28,7.3,350,2013,104.0,"Drama,Romance",7.8,42618
43,Grace Unplugged,1700000,2507159,2507159,5014318,3314318,en,1.957,2013-10-04,6.3,38,2013,102.0,"Drama,Music",6.2,3006
48,Braid,1660000,0,80745,80745,-1579255,en,5.972,2019-02-01,6.4,18,2018,82.0,"Horror,Mystery,Thriller",5.3,1115
54,N-Secure,1600000,2595644,2595644,5191288,3591288,en,1.132,2010-10-15,4.8,6,2010,105.0,"Crime,Drama,Thriller",3.6,587
56,Out of the Dark,1600000,419428,419428,838856,-761144,en,7.143,2015-02-27,4.8,79,2014,92.0,"Horror,Thriller",4.8,3691
60,Two Night Stand,1600000,15600,868081,883681,-716319,en,9.191,2014-09-26,6.5,1241,2014,86.0,"Comedy,Romance",6.4,60510
63,Insidious,1500000,54009150,99870886,153880036,152380036,en,16.197,2011-04-01,6.9,3582,2010,103.0,"Horror,Mystery,Thriller",6.9,254197
64,Moonlight,1500000,27854931,65245512,93100443,91600443,en,15.948,2016-10-21,7.4,3893,2016,111.0,Drama,7.4,227964
65,Cabin Fever,1500000,21158188,30351664,51509852,50009852,en,7.419,2016-02-12,4.6,215,2016,99.0,Horror,3.7,7873
70,Unsane,1500000,7690044,14244931,21934975,20434975,en,16.316,2018-03-23,6.2,667,2018,98.0,"Drama,Horror,Mystery",6.4,32049
74,Spellbound,1500000,7000000,7000000,14000000,12500000,en,0.6,2016-08-03,5.3,3,2011,114.0,"Comedy,Horror,Romance",6.9,2485
77,The To Do List,1500000,3491669,4128828,7620497,6120497,en,7.33,2013-07-26,5.5,534,2013,104.0,"Comedy,Romance",5.8,34524
78,The Gatekeepers,1500000,2408553,2592308,5000861,3500861,en,4.534,2013-02-01,7.2,51,2012,101.0,"Documentary,History,War",7.6,5214
84,The Lords of Salem,1500000,1165881,1541131,2707012,1207012,en,8.434,2013-04-19,5.3,445,2012,101.0,"Horror,Thriller",5.1,25089
85,31,1500000,779820,922727,1702547,202547,en,8.683,2016-10-21,5.2,370,2016,102.0,"Horror,Thriller",5.1,15055
87,Unsullied,1500000,510957,510957,1021914,-478086,en,2.478,2015-08-28,3.3,3,2014,93.0,"Action,Horror,Thriller",4.3,278
94,Amigo,1500000,184705,184705,369410,-1130590,en,0.84,2011-08-19,4.8,4,2010,124.0,"Drama,War",5.9,514
2,Road Hard,1500000,113169,113169,226338,-1273662,en,1.08,2015-03-06,6.6,12,2015,98.0,Comedy,6.1,1681
7,Housebound,1500000,0,236863,236863,-1263137,en,8.455,2014-10-17,6.6,505,2014,107.0,"Comedy,Horror,Mystery",6.8,29757
8,Teefa in Trouble,1500000,0,98806,98806,-1401194,ur,4.486,2018-07-20,7.6,11,2018,155.0,"Action,Comedy,Crime",7.4,2724
10,Closer to the Moon,1500000,0,5396,5396,-1494604,en,1.067,2013-11-29,7.2,19,2014,112.0,"Comedy,Crime,Drama",7.0,3585
12,The Lion of Judah,1500000,0,0,0,-1500000,en,1.4,2011-06-03,4.5,3,2011,87.0,Animation,3.8,511
16,#Horror,1500000,0,0,0,-1500000,de,6.099,2015-11-20,3.3,102,2015,101.0,"Crime,Drama,Horror",3.0,3092
17,Checkmate,1500000,0,0,0,-1500000,en,3.764,2015-07-03,4.2,20,2010,121.0,"Drama,Mystery",4.7,27
21,Mustang,1400000,845464,5552584,6398048,4998048,tr,7.459,2015-11-20,8.0,755,2015,97.0,Drama,7.6,30899
25,Eddie: The Sleepwalking Cannibal,1400000,1632,1632,3264,-1396736,en,2.586,2013-04-05,6.2,33,2012,90.0,"Comedy,Horror",5.6,1364
26,My Girlfriend's Boyfriend,1400000,0,0,0,-1400000,en,4.378,2010-04-22,5.9,68,2010,84.0,"Comedy,Romance",5.8,5461
28,House at the End of the Drive,1400000,0,0,0,-1400000,en,1.4,2014-01-11,8.0,1,2014,91.0,"Horror,Thriller",6.5,331
38,Above and Beyond,1300000,288751,288751,577502,-722498,en,0.782,2015-01-30,8.0,5,2014,90.0,"Adventure,Documentary,History",7.7,506
43,Simon,1300000,4055,1738663,1742718,442718,en,0.64,2017-02-01,0.0,1,2016,85.0,Thriller,4.8,47
46,The Algerian,1300000,0,0,0,-1300000,en,0.911,2015-08-07,4.5,2,2014,99.0,"Action,Romance,Thriller",5.3,195
51,Dear White People,1250000,4404154,5403771,9807925,8557925,en,7.455,2014-10-17,6.1,296,2014,108.0,"Comedy,Drama,Romance",6.1,23321
52,Filly Brown,1250000,2850357,2940411,5790768,4540768,en,1.31,2013-04-19,6.5,10,2012,80.0,"Drama,Music",5.7,1003
56,Da Sweet Blood of Jesus,1250000,0,0,0,-1250000,en,2.607,2014-06-22,4.6,33,2014,123.0,"Comedy,Romance,Thriller",4.1,1212
66,Home Run,1200000,2859955,2859955,5719910,4519910,en,3.843,2013-04-19,6.3,33,2010,82.0,"Drama,Family,Sport",4.2,66
72,Blue Like Jazz,1200000,595018,595018,1190036,-9964,en,3.253,2012-04-13,5.9,35,2012,108.0,"Comedy,Drama",5.9,2810
76,"Pink Ribbons, Inc.",1200000,26608,26608,53216,-1146784,en,1.4,2012-04-21,6.8,6,2011,97.0,Documentary,7.3,654
77,Blood Feast,1200000,8708,8708,17416,-1182584,en,3.402,2017-06-23,4.3,6,2016,90.0,Horror,4.9,653
83,Below Zero,1200000,0,0,0,-1200000,en,2.027,2011-10-22,5.2,17,2011,99.0,Thriller,4.4,740
84,Crowsnest,1200000,0,0,0,-1200000,en,1.755,2012-01-01,4.9,18,2012,84.0,"Horror,Mystery,Thriller",3.9,1481
85,Airborne,1200000,0,0,0,-1200000,en,2.877,2013-02-26,3.9,31,2012,81.0,"Comedy,Crime,Horror",3.9,2248
87,Bleeding Hearts,1200000,0,0,0,-1200000,en,0.6,2013-06-01,6.0,2,2015,100.0,Horror,3.4,123
88,The Wicked Within,1200000,0,0,0,-1200000,en,2.897,2015-10-16,4.4,28,2015,84.0,Horror,4.5,1123
100,Beyond the Black Rainbow,1100000,56491,56491,112982,-987018,en,7.331,2011-09-24,5.9,150,2010,110.0,"Horror,Sci-Fi,Thriller",6.0,10765
2,The Sleepwalker,1100000,2636,2636,5272,-1094728,en,2.659,2014-01-20,4.1,9,2014,91.0,Drama,4.9,632
3,Departure,1100000,0,27561,27561,-1072439,en,0.885,2016-05-12,10.0,1,2015,109.0,"Drama,Romance",6.7,1680
7,The Dead Undead,1100000,0,0,0,-1100000,en,3.127,2010-05-13,3.1,9,2010,89.0,"Action,Horror,Sci-Fi",3.0,791
8,The Vatican Exorcisms,1100000,0,0,0,-1100000,en,0.819,2013-05-29,4.2,14,2013,76.0,Horror,2.5,413
12,The Devil Inside,1000000,53262945,101759490,155022435,154022435,en,7.403,2012-01-06,4.7,441,2012,83.0,Horror,4.2,33522
14,Unfriended,1000000,32789645,64364198,97153843,96153843,en,8.12,2015-04-17,5.4,2019,2014,83.0,"Horror,Mystery,Thriller",5.6,62043
17,You're Next,1000000,18494006,26887177,45381183,44381183,en,11.45,2013-08-23,6.6,1258,2011,95.0,"Action,Comedy,Horror",6.6,79451
18,Chernobyl Diaries,1000000,18119640,42411721,60531361,59531361,en,14.658,2012-05-25,5.0,842,2012,86.0,"Horror,Mystery,Thriller",5.0,60304
25,Blue Valentine,1000000,9737892,16566240,26304132,25304132,en,8.994,2010-12-29,6.9,1677,2010,112.0,"Drama,Romance",7.4,170089
29,Unfriended: Dark Web,1000000,8866745,16434588,25301333,24301333,en,17.861,2018-07-20,6.1,365,2018,92.0,"Crime,Horror,Mystery",5.9,13822
31,The Green Inferno,1000000,7192291,12931420,20123711,19123711,en,13.67,2013-11-02,5.2,619,2013,100.0,"Adventure,Horror",5.3,33239
32,I Am Not Your Negro,1000000,7123919,9617402,16741321,15741321,en,7.026,2017-02-03,8.1,196,2016,93.0,Documentary,7.8,13948
33,The Sessions,1000000,6002451,11495204,17497655,16497655,en,6.46,2012-10-18,6.9,296,2012,95.0,"Biography,Comedy,Drama",7.2,39731
35,October Baby,1000000,5355847,5391992,10747839,9747839,en,4.835,2011-10-30,6.8,56,2011,107.0,Drama,6.8,6903
36,The Skeleton Twins,1000000,5284309,5797192,11081501,10081501,en,10.341,2014-09-12,6.7,394,2014,93.0,"Comedy,Drama,Romance",6.8,36793
41,Obvious Child,1000000,3122616,3324070,6446686,5446686,en,8.232,2014-06-06,6.7,256,2014,84.0,"Comedy,Drama,Romance",6.8,21536
42,Martha Marcy May Marlene,1000000,2981038,5438911,8419949,7419949,en,9.477,2011-10-21,6.7,413,2011,102.0,"Drama,Mystery,Thriller",6.9,45873
52,No Man's Land,1000000,1067481,2684207,3751688,2751688,en,0.6,2010-01-01,7.0,1,2013,118.0,"Adventure,Crime,Drama",7.3,1756
56,Patti Cake$,1000000,800148,1471090,2271238,1271238,en,6.934,2017-08-18,7.0,122,2017,109.0,"Drama,Music",6.7,8581
58,Palo Alto,1000000,767732,1156309,1924041,924041,en,7.262,2014-05-09,6.4,528,2013,100.0,Drama,6.2,25402
62,The Future,1000000,568662,1239174,1807836,807836,en,3.836,2011-07-29,5.8,38,2011,91.0,"Drama,Fantasy,Romance",6.2,7648
64,23 Blast,1000000,549185,549185,1098370,98370,en,2.213,2014-10-24,6.5,31,2014,98.0,"Drama,Family,Sport",6.5,1567
66,The Act of Killing,1000000,486919,1227316,1714235,714235,id,8.63,2012-08-31,7.8,326,2012,117.0,"Crime,Documentary",8.2,31115
70,I Origins,1000000,336472,852399,1188871,188871,en,8.459,2014-07-18,7.6,1814,2014,106.0,"Drama,Romance,Sci-Fi",7.4,104718
71,Antarctica: A Year on Ice,1000000,288757,288757,577514,-422486,en,2.061,2013-09-05,7.2,41,2013,91.0,"Adventure,Biography,Documentary",7.6,3004
74,The Invitation,1000000,231738,354836,586574,-413426,en,10.424,2015-03-13,6.5,1063,2015,100.0,"Drama,Horror,Mystery",6.7,70213
81,Hardflip,1000000,96734,96734,193468,-806532,en,1.186,2012-06-01,5.0,7,2012,112.0,"Action,Drama",5.6,673
82,Creative Control,1000000,63014,63014,126028,-873972,en,3.35,2016-03-11,5.6,36,2015,97.0,"Drama,Sci-Fi",5.4,1951
84,The Perfect Host,1000000,48764,51587,100351,-899649,en,6.088,2010-07-01,6.3,217,2010,93.0,"Comedy,Crime,Thriller",6.8,23378
88,Hits,1000000,15156,15156,30312,-969688,en,5.512,2014-01-21,5.0,36,2014,96.0,"Comedy,Drama",5.8,1706
92,Camp X-Ray,1000000,9837,101053,110890,-889110,en,15.237,2014-10-17,6.8,618,2014,117.0,"Drama,War",6.9,36700
94,The Sisterhood of Night,1000000,6870,6870,13740,-986260,en,3.314,2015-04-10,6.4,51,2014,104.0,"Drama,Mystery,Thriller",6.2,1888
100,Heli,1000000,0,552614,552614,-447386,es,3.01,2013-10-19,6.4,46,2013,105.0,"Crime,Drama,Romance",6.8,4379
3,American Hero,1000000,0,26,26,-999974,en,6.56,2015-12-11,5.0,93,2015,86.0,"Action,Comedy,Drama",4.9,3661
11,Snow White: A Deadly Summer,1000000,0,0,0,-1000000,en,3.595,2012-03-16,4.1,14,2012,83.0,Horror,2.2,679
13,Black Rock,1000000,0,0,0,-1000000,en,6.334,2012-01-21,4.9,118,2012,83.0,"Horror,Thriller",4.8,7596
14,Hidden Away,1000000,0,0,0,-1000000,es,2.222,2014-10-29,7.8,46,2014,96.0,"Drama,Romance",7.1,1820
15,My Last Day Without You,1000000,0,0,0,-1000000,de,2.007,2011-06-11,5.8,5,2011,90.0,"Comedy,Drama,Romance",5.7,1178
17,Doc Holliday's Revenge,1000000,0,0,0,-1000000,en,0.84,2014-06-01,3.2,3,2014,84.0,Western,3.8,104
19,Fear Clinic,1000000,0,0,0,-1000000,en,5.861,2014-10-31,4.2,63,2014,95.0,Horror,5.0,6256
22,Hush,1000000,0,0,0,-1000000,en,0.6,2015-03-27,6.0,1,2012,103.0,"Drama,Thriller",4.5,244
23,1982,1000000,0,0,0,-1000000,en,0.6,2013-12-31,7.5,2,2013,90.0,Drama,7.0,221
25,Chemical Cut,1000000,0,0,0,-1000000,en,0.639,2016-01-24,10.0,1,2016,83.0,Drama,5.4,111
30,Banshee Chapter,950000,0,78122,78122,-871878,en,6.872,2013-11-06,5.6,135,2013,87.0,"Horror,Sci-Fi,Thriller",5.5,8219
33,Ask Me Anything,950000,0,0,0,-950000,en,9.193,2014-04-19,5.6,246,2014,100.0,Drama,6.1,10680
34,L!fe Happens,930000,30905,30905,61810,-868190,en,5.334,2011-06-18,5.3,91,2011,100.0,Comedy,5.6,7229
35,Lowriders,916000,6179955,6188421,12368376,11452376,en,4.958,2017-05-12,6.5,46,2016,98.0,"Adventure,Crime,Drama",5.7,1954
38,Fruitvale Station,900000,16098998,17549645,33648643,32748643,en,9.587,2013-07-26,7.4,645,2013,85.0,"Biography,Drama,Romance",7.5,68187
39,Meet the Blacks,900000,9097072,9097072,18194144,17294144,en,6.131,2016-04-01,4.4,139,2016,94.0,"Comedy,Horror",5.9,34669
41,Circumstance,900000,454121,958978,1413099,513099,fa,2.86,2011-08-26,6.9,45,2011,107.0,Drama,5.9,7055
43,The Giant Mechanical Man,900000,7396,7396,14792,-885208,en,5.945,2012-04-27,6.3,70,2012,95.0,"Comedy,Drama,Romance",6.7,8921
44,The Brass Teapot,900000,6997,413733,420730,-479270,en,6.495,2013-04-05,6.0,240,2012,101.0,"Comedy,Fantasy,Thriller",6.4,13746
50,The Hammer,850000,442638,442638,885276,35276,en,1.961,2010-10-26,6.5,16,2010,108.0,"Biography,Drama,Sport",7.0,1613
51,Windsor Drive,850000,3256,3256,6512,-843488,en,1.608,2015-06-26,2.5,4,2015,90.0,"Mystery,Thriller",3.2,193
69,Not Cool,800000,35688,35688,71376,-728624,en,2.246,2014-09-23,4.2,50,2014,93.0,"Comedy,Drama,Romance",4.5,5089
70,Kill List,800000,29063,462206,491269,-308731,en,7.036,2012-01-04,6.1,332,2011,95.0,"Crime,Drama,Horror",6.4,32807
71,Vessel,800000,0,0,0,-800000,en,1.266,2012-10-28,6.3,13,2013,,Sci-Fi,6.4,23
75,Kevin Hart: Laugh at My Pain,750000,7706436,7712436,15418872,14668872,en,6.558,2011-09-09,7.4,76,2011,89.0,"Comedy,Documentary",7.4,5081
77,Safety Not Guaranteed,750000,4010957,4422318,8433275,7683275,en,9.214,2012-06-08,6.9,792,2012,86.0,"Comedy,Drama,Romance",7.0,111907
78,The Innkeepers,750000,78396,1011535,1089931,339931,en,8.494,2011-12-30,5.5,324,2011,101.0,"Drama,Horror,Mystery",5.5,31089
86,Adulterers,750000,0,0,0,-750000,en,8.058,2016-01-05,5.2,29,2015,91.0,"Crime,Drama,Thriller",5.2,1377
93,Columbus,700000,1017107,1110511,2127618,1427618,en,8.964,2017-08-04,7.3,130,2015,127.0,Comedy,7.3,42
96,Walter,700000,0,0,0,-700000,en,3.277,2015-03-13,5.5,31,2015,94.0,"Comedy,Drama",5.4,1747
100,Escape from Tomorrow,650000,171962,171962,343924,-306076,en,5.743,2013-10-11,4.8,117,2013,90.0,"Drama,Fantasy,Horror",5.2,8665
2,After,650000,0,0,0,-650000,en,7.712,2012-09-14,5.7,86,2014,99.0,"Drama,Mystery",4.7,129
5,Treachery,625000,0,0,0,-625000,en,1.874,2013-12-04,4.8,5,2013,67.0,"Drama,Thriller",3.7,391
12,Water & Power,600000,42557,42557,85114,-514886,en,0.628,2014-05-02,3.0,1,2013,88.0,"Crime,Drama",6.2,99
15,Drunk Wedding,600000,3301,3301,6602,-593398,en,1.4,2015-05-22,3.9,15,2015,81.0,Comedy,4.6,729
16,They Will Have to Kill Us First,600000,0,7943,7943,-592057,fr,0.6,2015-08-04,5.0,1,2015,100.0,Documentary,7.3,112
18,The Maid's Room,600000,0,0,0,-600000,en,0.849,2014-08-08,4.8,6,2013,98.0,Thriller,4.5,882
27,Faith Connections,550000,9111,9111,18222,-531778,hi,0.6,2013-11-21,4.2,3,2013,115.0,"Biography,Documentary,Drama",7.1,149
28,High Road,546173,0,0,0,-546173,en,3.38,2012-03-06,5.6,38,2011,87.0,Comedy,5.4,1508
30,Benji,500000,31559560,31559560,63119120,62619120,en,0.716,2012-10-23,8.0,4,2018,87.0,"Crime,Drama,Family",6.4,2779
45,Drinking Buddies,500000,343706,407100,750806,250806,en,8.997,2013-08-23,6.0,528,2013,90.0,"Comedy,Drama,Romance",6.1,53546
50,Monsters,500000,237301,5639730,5877031,5377031,en,10.175,2010-10-29,6.2,848,2010,94.0,"Drama,Sci-Fi,Thriller",6.4,84332
52,Deceptive Practice: The Mysteries and Mentors of Ricky Jay,500000,152449,152449,304898,-195102,en,1.076,2012-10-04,7.1,18,2012,88.0,Documentary,7.1,882
53,The Other Dream Team,500000,134109,314444,448553,-51447,lt,1.304,2012-09-28,7.5,12,2012,89.0,"Documentary,Sport",8.4,3332
55,Rubber,500000,100370,680914,781284,281284,en,8.319,2010-09-01,5.9,417,2010,82.0,"Comedy,Fantasy,Horror",5.8,31316
59,The Journey,500000,19800,19800,39600,-460400,en,1.893,2017-06-16,6.7,20,2010,,Family,6.4,12
65,Born to Fly: Elizabeth Streb vs. Gravity,500000,1822,1822,3644,-496356,en,0.6,2014-03-08,5.5,2,2014,82.0,"Action,Biography,Documentary",6.7,47
66,Detention of the Dead,500000,1778,1778,3556,-496444,en,4.268,2012-04-27,5.0,50,2012,87.0,"Action,Adventure,Comedy",4.6,2414
67,Higher Power,500000,528,528,1056,-498944,en,7.544,2018-05-11,4.9,43,2018,93.0,"Action,Sci-Fi,Thriller",5.3,2152
72,Drones,500000,0,0,0,-500000,en,1.421,2010-01-23,5.2,5,2010,98.0,Comedy,6.4,483
73,Enter Nowhere,500000,0,0,0,-500000,en,6.899,2011-10-22,6.7,83,2011,90.0,"Mystery,Sci-Fi,Thriller",6.6,7298
74,Girls Gone Dead,500000,0,0,0,-500000,en,5.405,2012-03-28,3.5,20,2012,104.0,"Comedy,Horror",3.5,2230
77,The Outrageous Sophie Tucker,500000,0,0,0,-500000,en,0.628,2014-05-02,6.0,1,2014,96.0,Documentary,7.3,60
78,Subconscious,500000,0,0,0,-500000,en,0.855,2015-03-10,3.1,7,2010,72.0,Horror,4.5,172
79,Roadside,500000,0,0,0,-500000,en,0.746,2013-03-01,4.2,5,2013,90.0,"Drama,Horror,Mystery",3.8,361
80,Diamond Ruff,500000,0,0,0,-500000,en,0.776,2015-01-01,2.4,4,2015,82.0,Action,4.3,65
81,Love in the Time of Monsters,500000,0,0,0,-500000,en,0.6,2014-03-08,5.0,2,2014,97.0,"Comedy,Horror",5.5,183
83,Fight to the Finish,500000,0,0,0,-500000,en,0.6,2016-02-02,5.2,3,2016,94.0,"Action,Romance,Sport",3.6,109
87,Alleluia! The Devil's Carnival,500000,0,0,0,-500000,en,3.058,2016-03-29,7.0,9,2016,97.0,"Horror,Musical",6.9,534
90,Rodeo Girl,500000,0,0,0,-500000,en,0.809,2016-01-05,5.1,6,2016,108.0,"Adventure,Family",5.8,175
100,As It Is in Heaven,450000,13486,13486,26972,-423028,en,0.629,2014-08-15,8.0,1,2014,86.0,Drama,7.3,73
7,Blue Ruin,420000,258384,437002,695386,275386,en,7.983,2014-04-25,6.9,736,2013,90.0,"Crime,Drama,Thriller",7.1,58811
14,I Want Your Money,400000,433588,433588,867176,467176,en,0.744,2010-07-06,4.2,5,2010,92.0,Documentary,5.1,1244
17,Jackpot,400000,44452,44452,88904,-311096,en,0.6,2012-07-14,6.0,1,2011,86.0,"Action,Comedy,Crime",6.6,2941
28,Maniac,350000,10000000,10000000,20000000,19650000,fr,1.492,2011-10-31,6.1,9,2011,160.0,"Action,Horror,Thriller",4.8,5
35,Rotor DR1,350000,0,0,0,-350000,en,1.247,2015-10-20,4.3,4,2015,98.0,"Family,Sci-Fi",3.4,280
51,3 Backyards,300000,39475,39475,78950,-221050,en,2.079,2010-01-24,4.3,6,2010,88.0,Drama,5.0,611
57,Locker 13,300000,3496,3496,6992,-293008,en,0.732,2014-03-29,6.4,4,2014,90.0,Thriller,4.7,290
58,The Looking Glass,300000,1711,1711,3422,-296578,en,0.6,2011-01-01,5.0,1,2011,80.0,Fantasy,5.5,36
61,Some Guy Who Kills People,300000,0,0,0,-300000,en,5.908,2012-10-05,6.1,59,2011,97.0,"Comedy,Crime,Drama",6.3,5111
63,Teeth and Blood,300000,0,0,0,-300000,en,0.6,2015-03-10,3.0,1,2015,96.0,"Action,Horror",4.0,34
65,Anderson's Cross,300000,0,0,0,-300000,en,0.6,2010-05-20,5.0,1,2010,98.0,"Comedy,Drama,Romance",5.5,106
68,Compliance,270000,319285,830700,1149985,879985,en,6.93,2012-08-24,6.4,340,2012,90.0,"Biography,Crime,Drama",6.4,28703
69,Graduation Day,250000,23894000,23894000,47788000,47538000,en,0.6,2015-01-01,5.0,1,2015,75.0,Thriller,5.0,52
72,Sleight,250000,3930990,3934450,7865440,7615440,en,5.664,2017-04-28,5.3,367,2016,89.0,"Action,Drama,Sci-Fi",5.9,7074
74,Like Crazy,250000,3395391,3728400,7123791,6873791,en,10.091,2011-10-28,6.5,638,2011,86.0,"Drama,Romance",6.7,55841
81,November,250000,191862,191862,383724,133724,et,2.519,2018-02-23,7.6,38,2017,115.0,"Drama,Fantasy,Horror",7.2,2455
83,Happy Valley,250000,67665,67665,135330,-114670,en,2.309,2014-11-14,6.7,25,2014,98.0,"Documentary,Drama,Sport",7.1,1059
84,The Canyons,250000,59671,62375,122046,-127954,en,6.937,2013-07-29,4.3,134,2013,99.0,"Drama,Thriller",3.8,9838
89,Test,250000,18823,18823,37646,-212354,en,2.13,2013-06-29,7.2,37,2013,89.0,Drama,6.2,1373
93,Rust,250000,0,0,0,-250000,en,0.66,2010-10-07,8.0,1,2010,95.0,Drama,5.6,404
94,The Christmas Bunny,250000,0,0,0,-250000,en,1.4,2010-11-28,6.1,11,2010,98.0,"Drama,Family",6.1,662
96,The Frozen,250000,0,0,0,-250000,en,1.928,2012-10-10,4.2,20,2012,95.0,"Drama,Thriller",4.4,1641
98,Butterfly,250000,0,0,0,-250000,en,0.6,2010-10-31,5.5,2,2010,90.0,"Horror,Thriller",4.7,53
100,Horse Camp,250000,0,0,0,-250000,en,0.6,2015-01-10,5.5,2,2017,108.0,Family,6.7,82
1,Give Me Shelter,250000,0,0,0,-250000,en,0.6,2014-06-24,2.0,1,2014,90.0,Documentary,7.6,56
10,Burn,225000,1109276,1109276,2218552,1993552,en,0.6,2011-01-01,9.0,1,2012,86.0,Documentary,7.5,663
18,The Grace Card,200000,2430735,2430735,4861470,4661470,en,2.142,2011-02-25,6.5,18,2010,101.0,Drama,6.6,2488
21,The Overnight,200000,1109808,1165996,2275804,2075804,en,6.576,2015-06-19,6.0,200,2010,88.0,,7.5,24
23,Middle of Nowhere,200000,236806,236806,473612,273612,en,4.046,2010-07-13,5.9,35,2012,97.0,Drama,6.4,1406
33,The Word,200000,3648,3648,7296,-192704,pl,0.84,2014-04-22,4.8,15,2013,104.0,Drama,6.7,97
41,Perfect Cowboy,200000,0,0,0,-200000,en,1.379,2014-07-13,5.0,1,2014,109.0,Drama,5.9,37
42,H.,200000,0,0,0,-200000,en,2.157,2014-09-07,6.3,8,2014,93.0,"Drama,Sci-Fi,Thriller",5.9,443
43,Weekend,190000,484592,1577585,2062177,1872177,en,8.326,2011-09-22,7.5,287,2011,97.0,"Drama,Romance",7.6,25424
45,Butterfly Girl,180000,17503,17503,35006,-144994,en,0.632,2014-03-10,5.0,1,2014,78.0,Documentary,8.6,43
48,Another Earth,175000,1321194,2102779,3423973,3248973,en,10.03,2011-07-22,6.7,853,2011,92.0,"Drama,Romance,Sci-Fi",7.0,85839
49,Sparrows Dance,175000,2602,2602,5204,-169796,en,0.968,2013-08-23,7.4,6,2012,81.0,"Comedy,Drama,Romance",6.8,550
51,The Fits,170000,166425,169242,335667,165667,en,4.938,2016-01-22,6.6,66,2015,72.0,"Drama,Music",6.7,4053
61,Top Spin,150000,5858,5858,11716,-138284,en,1.249,2014-11-15,6.9,10,2014,80.0,Documentary,6.9,513
62,Speak No Evil,150000,0,32927,32927,-117073,en,2.443,2013-05-24,3.6,19,2013,74.0,Horror,3.6,534
64,Aroused,150000,0,0,0,-150000,en,2.017,2013-02-20,6.6,18,2013,66.0,Documentary,5.3,596
68,Sound of My Voice,135000,408015,429448,837463,702463,en,7.212,2011-01-22,6.4,169,2011,85.0,"Drama,Mystery,Sci-Fi",6.6,19387
73,Your Sister's Sister,120000,1597486,3090593,4688079,4568079,en,7.115,2012-06-14,6.6,192,2011,90.0,"Comedy,Drama",6.7,24780
80,The Gallows,100000,22764410,41656474,64420884,64320884,en,9.166,2015-07-10,4.8,591,2015,81.0,"Horror,Mystery,Thriller",4.2,17763
86,A Ghost Story,100000,1594798,2769782,4364580,4264580,en,11.886,2017-07-07,7.0,906,2017,92.0,"Drama,Fantasy,Romance",6.8,46280
89,Cheap Thrills,100000,59424,59424,118848,18848,en,6.406,2013-03-08,6.4,216,2013,88.0,"Comedy,Crime,Drama",6.7,16429
92,Indie Game: The Movie,100000,0,0,0,-100000,en,6.202,2012-05-18,7.8,259,2012,103.0,"Documentary,Drama",7.7,19538
94,Echo Dr.,100000,0,0,0,-100000,en,0.907,2013-11-08,4.5,2,2013,81.0,"Action,Drama,Sci-Fi",3.6,112
95,Closure,100000,0,0,0,-100000,en,0.6,2013-12-01,8.0,1,2010,95.0,Thriller,5.5,95
97,Open Secret,100000,0,0,0,-100000,en,0.6,2013-11-03,7.0,1,2011,55.0,Documentary,6.5,39
98,The Night Visitor,100000,0,0,0,-100000,en,0.671,2015-11-22,4.5,2,2013,91.0,"Horror,Sci-Fi,Thriller",4.8,95
99,Tiger Orange,100000,0,0,0,-100000,en,2.62,2014-07-26,6.2,8,2014,75.0,Drama,6.6,1053
2,Dawn of the Crescent Moon,75000,8799,8799,17598,-57402,en,1.4,2014-04-05,2.0,1,2014,95.0,"Drama,Sci-Fi,Thriller",5.1,42
3,Queen Crab,75000,0,0,0,-75000,en,1.252,2015-09-29,3.2,5,2015,80.0,"Action,Sci-Fi,Thriller",4.2,196
4,Happy Christmas,70000,30312,30312,60624,-9376,en,5.767,2014-06-26,5.1,95,2014,82.0,"Comedy,Drama",5.5,7217
6,Absentia,70000,0,8555,8555,-61445,en,10.357,2011-03-03,5.9,175,2011,87.0,"Drama,Horror,Mystery",5.8,15507
11,Supporting Characters,60000,4917,4917,9834,-50166,en,1.907,2012-01-23,6.7,13,2012,87.0,Comedy,6.4,821
12,The FP,60000,0,0,0,-60000,en,2.007,2011-03-13,5.4,16,2011,82.0,Comedy,5.6,1541
13,Hayride,60000,0,0,0,-60000,en,2.914,2012-10-13,4.6,10,2012,93.0,"Crime,Drama,Horror",3.4,622
15,The Dirties,55000,0,0,0,-55000,en,2.971,2013-10-04,6.1,57,2013,83.0,"Crime,Drama",6.8,5728
18,Tiny Furniture,50000,391674,424149,815823,765823,en,6.695,2010-11-12,5.9,82,2010,98.0,"Comedy,Drama,Romance",6.2,13397
20,Counting,50000,8374,8374,16748,-33252,en,0.6,2015-07-31,8.3,3,2015,111.0,Documentary,6.0,126
22,Down and Dangerous,50000,0,0,0,-50000,en,2.621,2014-02-14,4.3,9,2013,95.0,"Crime,Thriller",5.2,846
24,Bending Steel,50000,0,0,0,-50000,en,0.6,2013-04-20,5.0,1,2013,92.0,Documentary,7.9,60
25,"Run, Hide, Die",50000,0,0,0,-50000,en,0.6,2015-09-01,3.5,2,2012,104.0,"Horror,Thriller",3.5,162
26,The Image Revolution,50000,0,0,0,-50000,en,1.313,2013-11-21,6.3,4,2014,81.0,"Biography,Documentary",7.2,156
27,A True Story,45000,0,0,0,-45000,en,1.218,2013-09-20,6.6,4,2013,96.0,Comedy,5.2,211
29,This Is Martin Bonner,42000,0,0,0,-42000,en,1.897,2013-06-28,5.7,9,2013,83.0,Drama,6.6,846
32,Raymond Did It,40000,3632,3632,7264,-32736,en,1.675,2011-03-27,3.7,8,2011,83.0,Horror,3.3,211
33,Foreign Letters,40000,0,0,0,-40000,en,0.6,2012-04-22,5.3,3,2012,99.0,"Comedy,Drama",6.9,180
35,Her Cry: La Llorona Investigation,35000,0,0,0,-35000,en,0.6,2013-04-19,5.0,2,2013,89.0,Horror,3.7,70
36,Happy 40th,35000,0,0,0,-35000,en,0.6,2015-05-29,6.0,2,2015,100.0,Drama,6.3,51
38,Krisha,30000,144822,144822,289644,259644,en,0.6,2014-03-07,9.0,1,2015,83.0,Drama,7.2,5917
45,Emily,27000,3547,3547,7094,-19906,en,0.6,2013-06-21,7.0,1,2017,83.0,Drama,6.8,13
49,Exeter,25000,0,489792,489792,464792,en,5.934,2015-03-26,4.7,121,2015,91.0,"Horror,Mystery,Thriller",4.5,5156
51,Ten,25000,0,0,0,-25000,en,1.575,2014-03-28,5.4,5,2013,118.0,Drama,5.5,31
54,Dry Spell,22000,0,0,0,-22000,en,0.6,2013-02-14,6.0,1,2013,90.0,"Comedy,Romance",3.3,120
56,All Superheroes Must Die,20000,0,0,0,-20000,en,2.078,2013-01-04,3.9,19,2011,78.0,"Sci-Fi,Thriller",4.0,1977
73,Newlyweds,9000,4584,4584,9168,168,en,1.973,2011-12-26,5.4,7,2011,95.0,"Comedy,Drama",6.4,1436
