movie,runtime_minutes,genres,averagerating,numvotes,production_budget,domestic_gross,worldwide_gross,net_revenue,ROI%
The Legend of Hercules,99.0,"Action,Adventure,Fantasy",4.2,50352,70000000,18848538,58953319,-11046681,-0.15780972857142858
21 Jump Street,109.0,"Action,Comedy,Crime",7.2,477771,42000000,138447667,202812429,160812429,3.8288673571428573
Reign of Assassins,117.0,"Action,Adventure",6.9,6990,14000000,0,11354230,-2645770,-0.18898357142857142
The Revenant,156.0,"Action,Adventure,Biography",8.0,621193,135000000,183637894,532938302,397938302,2.947691125925926
Machete,105.0,"Action,Crime,Thriller",6.6,182320,12500000,26593646,46370970,33870970,2.7096776
Iron Man 2,124.0,"Action,Adventure,Sci-Fi",7.0,657690,170000000,312433331,621156389,451156389,2.653861111764706
Central Intelligence,107.0,"Action,Comedy,Crime",6.3,138872,50000000,127440871,217194805,167194805,3.3438961
The Host,125.0,"Action,Adventure,Drama",5.9,105633,50000000,26623701,64477051,14477051,0.28954102
The Commuter,105.0,"Action,Mystery,Thriller",6.3,83114,40000000,36343858,101985431,61985431,1.549635775
The Grey,117.0,"Action,Adventure,Drama",6.8,228798,25000000,51580136,81249176,56249176,2.24996704
Abraham Lincoln: Vampire Hunter,105.0,"Action,Fantasy,Horror",5.9,142853,67500000,37519139,137489730,69989730,1.0368848888888889
The Last Witch Hunter,106.0,"Action,Adventure,Fantasy",6.0,86118,80000000,27367660,130818912,50818912,0.6352364
Resident Evil: Retribution,95.0,"Action,Horror,Sci-Fi",5.4,125191,65000000,42345531,240647629,175647629,2.7022712153846156
The Croods,98.0,"Action,Adventure,Animation",7.2,176699,135000000,187168425,573068425,438068425,3.2449512962962963
The Bounty Hunter,110.0,"Action,Comedy,Romance",5.6,112444,45000000,67061228,135808837,90808837,2.0179741555555557
The Karate Kid,140.0,"Action,Drama,Family",6.2,146401,40000000,176591618,351774938,311774938,7.79437345
Legend of the Guardians: The Owls of Ga'Hoole,97.0,"Action,Adventure,Animation",7.0,73790,100000000,55675313,139716717,39716717,0.39716717
The Expendables,103.0,"Action,Adventure,Thriller",6.5,307897,82000000,103068524,268268174,186268174,2.2715630975609757
Pride and Prejudice and Zombies,108.0,"Action,Comedy,Horror",5.8,46187,28000000,10907291,16638300,-11361700,-0.405775
Men in Black 3,106.0,"Action,Adventure,Comedy",6.8,309879,215000000,179020854,654213485,439213485,2.042853418604651
Sherlock Holmes: A Game of Shadows,129.0,"Action,Adventure,Crime",7.5,394189,125000000,186848418,535663443,410663443,3.285307544
The Book of Eli,118.0,"Action,Adventure,Drama",6.9,271307,80000000,94835059,158750817,78750817,0.9843852125
Escape Plan,115.0,"Action,Crime,Mystery",6.7,211587,70000000,25135965,103735965,33735965,0.48194235714285716
Wild Target,98.0,"Action,Comedy,Crime",6.8,33915,8000000,109338,5314194,-2685806,-0.33572575
Hercules,98.0,"Action,Adventure,Fantasy",6.0,137287,100000000,72688614,243388614,143388614,1.43388614
Venom,112.0,"Action,Sci-Fi,Thriller",6.7,275406,116000000,213511408,853628605,737628605,6.358867284482758
The Watch,102.0,"Action,Comedy,Horror",5.7,115757,55000000,34353000,67130045,12130045,0.22054627272727273
Pirates of the Caribbean: On Stranger Tides,136.0,"Action,Adventure,Fantasy",6.6,447624,410600000,241063875,1045663875,635063875,1.5466728567949342
12 Strong,130.0,"Action,Drama,History",6.6,50155,35000000,45819713,71118378,36118378,1.0319536571428571
Act of Valor,110.0,"Action,Adventure,Drama",6.5,63787,12000000,70012847,82497035,70497035,5.874752916666667
A Walk Among the Tombstones,114.0,"Action,Crime,Drama",6.5,105116,28000000,26017685,62108587,34108587,1.2181638214285715
Jack Reacher,130.0,"Action,Crime,Thriller",7.0,284547,60000000,80070736,217370736,157370736,2.6228456
Dracula Untold,92.0,"Action,Drama,Fantasy",6.3,164829,70000000,55991880,220241723,150241723,2.1463103285714284
The Amazing Spider-Man,136.0,"Action,Adventure,Sci-Fi",7.0,525632,220000000,262030663,757890267,537890267,2.444955759090909
Admiral,151.0,"Action,Adventure,Biography",7.0,7978,20000000,0,38585047,18585047,0.92925235
Hell or High Water,102.0,"Action,Crime,Drama",7.6,176469,12000000,27007844,37584304,25584304,2.1320253333333334
Captive,97.0,"Action,Crime,Drama",5.4,6017,2000000,2583301,2791973,791973,0.3959865
Godzilla: King of the Monsters,132.0,"Action,Adventure,Fantasy",6.7,36479,170000000,85576941,299276941,129276941,0.7604525941176471
The Equalizer 2,121.0,"Action,Crime,Thriller",6.7,97963,77000000,102084362,190453132,113453132,1.4734172987012988
Only the Brave,134.0,"Action,Biography,Drama",7.7,45482,38000000,18340051,24555177,-13444823,-0.3538111315789474
Kites,123.0,"Action,Drama,Romance",6.1,11353,9200000,1685269,17155193,7955193,0.8646948913043478
Ghost in the Shell,107.0,"Action,Drama,Sci-Fi",6.4,176499,110000000,40563557,167910690,57910690,0.5264608181818182
Immortals,110.0,"Action,Drama,Fantasy",6.0,152992,75000000,83504017,211562435,136562435,1.8208324666666666
The Spy Next Door,94.0,"Action,Comedy,Family",5.5,36767,28000000,24307106,46752858,18752858,0.6697449285714285
Oldboy,104.0,"Action,Drama,Mystery",5.8,63231,3000000,707391,6239723,3239723,1.0799076666666667
Mad Max: Fury Road,120.0,"Action,Adventure,Sci-Fi",8.1,780910,150000000,153636354,370098020,220098020,1.4673201333333334
The Lego Movie,100.0,"Action,Adventure,Animation",7.8,304179,60000000,257784718,457729388,397729388,6.628823133333333
The Kid Who Would Be King,120.0,"Action,Adventure,Family",6.0,8044,59000000,16790790,28348446,-30651554,-0.5195178644067796
Total Recall,118.0,"Action,Adventure,Mystery",6.3,228460,125000000,58877969,211856088,86856088,0.694848704
Attack the Block,88.0,"Action,Comedy,Sci-Fi",6.7,93868,13000000,1024175,6459183,-6540817,-0.5031397692307692
Drive Angry,104.0,"Action,Fantasy,Thriller",5.4,90203,50000000,10721033,41042583,-8957417,-0.17914834
The Foreigner,113.0,"Action,Thriller",7.0,81288,35000000,34393507,140783360,105783360,3.0223817142857143
Warcraft,123.0,"Action,Adventure,Fantasy",6.9,225557,160000000,47225655,425522281,265522281,1.65951425625
The Green Hornet,119.0,"Action,Comedy,Crime",5.8,148622,110000000,98780042,229155503,119155503,1.0832318454545455
American Sniper,133.0,"Action,Biography,Drama",7.3,401915,58000000,350126372,547326372,489326372,8.436661586206897
Valerian and the City of a Thousand Planets,137.0,"Action,Adventure,Fantasy",6.5,139792,180000000,40479370,215098356,35098356,0.19499086666666668
Birth of the Dragon,95.0,"Action,Biography,Drama",5.4,6090,31000000,6901965,7220490,-23779510,-0.7670809677419355
Dark Phoenix,113.0,"Action,Adventure,Sci-Fi",6.0,24451,350000000,42762350,149762350,-200237650,-0.5721075714285714
Jonah Hex,81.0,"Action,Drama,Fantasy",4.7,51860,47000000,10547117,11022696,-35977304,-0.7654745531914894
MacGruber,90.0,"Action,Comedy,Romance",5.5,39782,10000000,8525600,8629895,-1370105,-0.1370105
Kick-Ass 2,103.0,"Action,Comedy,Crime",6.6,238832,28000000,28795985,63129909,35129909,1.2546396071428572
Pacific Rim,131.0,"Action,Adventure,Sci-Fi",6.9,443667,190000000,101802906,411002906,221002906,1.1631731894736843
X-Men: Days of Future Past,132.0,"Action,Adventure,Sci-Fi",8.0,620079,200000000,233921534,747862775,547862775,2.739313875
Jurassic World,124.0,"Action,Adventure,Sci-Fi",7.0,539338,215000000,652270625,1648854864,1433854864,6.669092390697674
John Carter,132.0,"Action,Adventure,Sci-Fi",6.6,241792,275000000,73058679,282778100,7778100,0.028284
The Bourne Legacy,135.0,"Action,Adventure,Thriller",6.7,268678,125000000,113203870,280355920,155355920,1.24284736
Bullet to the Head,92.0,"Action,Crime,Thriller",5.7,44816,55000000,9489829,22597969,-32402031,-0.5891278363636364
Dredd,95.0,"Action,Crime,Sci-Fi",7.1,234616,45000000,13414714,41467606,-3532394,-0.07849764444444444
Unknown,113.0,"Action,Mystery,Thriller",6.9,235167,40000000,63686397,136123083,96123083,2.403077075
Baywatch,116.0,"Action,Comedy,Crime",5.6,137528,60000000,58060186,175863783,115863783,1.93106305
Ender's Game,114.0,"Action,Adventure,Fantasy",6.6,211722,110000000,61737191,127983283,17983283,0.16348439090909092
Deepwater Horizon,107.0,"Action,Drama,History",7.1,133303,156000000,61433527,122603824,-33396176,-0.2140780512820513
The Purge: Election Year,108.0,"Action,Horror,Sci-Fi",6.0,80254,10000000,79042440,118514727,108514727,10.8514727
Jurassic World: Fallen Kingdom,128.0,"Action,Adventure,Sci-Fi",6.2,219125,170000000,417719760,1305772799,1135772799,6.681016464705882
Wonder Woman,141.0,"Action,Adventure,Fantasy",7.5,487527,150000000,412563408,821133378,671133378,4.47422252
Season of the Witch,95.0,"Action,Adventure,Fantasy",5.4,85777,40000000,24827228,91126600,51126600,1.278165
The Dark Knight Rises,164.0,"Action,Thriller",8.4,1387769,275000000,448139099,1084439099,809439099,2.9434149054545453
Haywire,93.0,"Action,Drama,Thriller",5.8,78681,23000000,18942396,36374700,13374700,0.5815086956521739
Mortal Engines,128.0,"Action,Adventure,Fantasy",6.1,70193,100000000,15951040,85287417,-14712583,-0.14712583
The Hit List,90.0,"Action,Thriller",5.4,11081,6000000,0,0,-6000000,-1.0
Black Panther,134.0,"Action,Adventure,Sci-Fi",7.3,516148,200000000,700059566,1348258224,1148258224,5.74129112
Bajrangi Bhaijaan,163.0,"Action,Comedy,Drama",8.0,63747,13000000,8178001,121778347,108778347,8.367565153846154
Kingsman: The Golden Circle,141.0,"Action,Adventure,Comedy",6.8,230797,104000000,100234838,408803696,304803696,2.930804769230769
Alita: Battle Angel,122.0,"Action,Adventure,Sci-Fi",7.5,88207,170000000,85710210,402976036,232976036,1.3704472705882353
Tower Heist,104.0,"Action,Comedy,Crime",6.2,125102,85000000,78046570,150422946,65422946,0.7696817176470588
Unstoppable,98.0,"Action,Thriller",6.8,173019,95000000,81562942,165720921,70720921,0.7444307473684211
Legion,100.0,"Action,Fantasy,Horror",5.2,92709,26000000,40168080,67647574,41647574,1.6018297692307693
Captain Marvel,123.0,"Action,Adventure,Sci-Fi",7.0,296225,175000000,426525952,1123061550,948061550,5.417494571428572
The First Purge,98.0,"Action,Horror,Sci-Fi",5.1,41741,13000000,69488745,136617305,123617305,9.509023461538462
Conan the Barbarian,113.0,"Action,Adventure,Fantasy",5.2,90834,90000000,21295021,63356133,-26643867,-0.2960429666666667
Salt,100.0,"Action,Mystery,Thriller",6.4,277204,130000000,118311368,290650494,160650494,1.2357730307692307
The Sorcerer's Apprentice,109.0,"Action,Adventure,Family",6.1,143862,160000000,63150991,217986320,57986320,0.3624145
San Andreas,114.0,"Action,Adventure,Drama",6.1,192750,110000000,155190832,456258539,346258539,3.1478049
The Heat,117.0,"Action,Comedy,Crime",6.6,153501,43000000,159581587,229727774,186727774,4.342506372093023
Fury,134.0,"Action,Drama,War",7.6,381993,80000000,85817906,210315681,130315681,1.6289460125
Bumblebee,114.0,"Action,Adventure,Sci-Fi",6.9,94155,102000000,127195589,465195589,363195589,3.560741068627451
Ant-Man and the Wasp,118.0,"Action,Adventure,Comedy",7.1,244024,130000000,216648740,623144660,493144660,3.7934204615384615
Ghost Rider: Spirit of Vengeance,96.0,"Action,Fantasy,Thriller",4.3,103608,57000000,51774002,149217355,92217355,1.6178483333333333
Into the Storm,89.0,"Action,Adventure,Drama",5.8,60894,50000000,47602194,150429371,100429371,2.00858742
Transcendence,119.0,"Action,Drama,Sci-Fi",6.3,204481,100000000,23022309,103039258,3039258,0.03039258
Batman v Superman: Dawn of Justice,151.0,"Action,Adventure,Fantasy",6.5,576909,250000000,330360194,867500281,617500281,2.470001124
Risen,107.0,"Action,Adventure,Drama",6.3,22813,20000000,36880033,46255763,26255763,1.31278815
Solo: A Star Wars Story,135.0,"Action,Adventure,Fantasy",7.0,226243,275000000,213767512,393151347,118151347,0.4296412618181818
Thor,115.0,"Action,Adventure,Fantasy",7.0,683264,150000000,181030624,449326618,299326618,1.9955107866666666
Priest,87.0,"Action,Adventure,Fantasy",5.7,108320,60000000,29136626,84154026,24154026,0.4025671
How to Train Your Dragon,98.0,"Action,Adventure,Animation",8.1,611299,165000000,217581232,494870992,329870992,1.9992181333333334
Rush,123.0,"Action,Biography,Drama",8.1,393437,38000000,26947624,98230839,60230839,1.5850220789473684
Machete Kills,107.0,"Action,Crime,Sci-Fi",5.6,69968,20000000,8008161,18273009,-1726991,-0.08634955
The Finest Hours,117.0,"Action,Drama,History",6.8,55981,70000000,27569558,49252761,-20747239,-0.2963891285714286
Pixels,105.0,"Action,Comedy,Sci-Fi",5.6,119789,90000000,78765986,244041804,154041804,1.7115756
Gods of Egypt,127.0,"Action,Adventure,Fantasy",5.4,95111,140000000,31153464,138836756,-1163244,-0.008308885714285714
Furious 7,137.0,"Action,Crime,Thriller",7.2,335074,190000000,353007020,1518722794,1328722794,6.9932778631578945
Kong: Skull Island,118.0,"Action,Adventure,Fantasy",6.6,237720,185000000,168052812,561072059,376072059,2.0328219405405403
Proud Mary,89.0,"Action,Crime,Drama",4.9,6805,30000000,20868638,21709539,-8290461,-0.2763487
Puss in Boots,90.0,"Action,Adventure,Animation",6.6,133355,130000000,149260504,554987477,424987477,3.2691344384615384
Free State of Jones,139.0,"Action,Biography,Drama",6.9,45135,50000000,20810036,23237252,-26762748,-0.53525496
Wolves,91.0,"Action,Fantasy,Horror",5.3,7312,18000000,0,94953,-17905047,-0.9947248333333333
30 Minutes or Less,83.0,"Action,Comedy,Crime",6.1,87254,28000000,37053924,40966716,12966716,0.463097
Snowpiercer,126.0,"Action,Drama,Sci-Fi",7.1,239264,40000000,4563029,88069880,48069880,1.201747
Green Lantern,114.0,"Action,Adventure,Sci-Fi",5.5,252281,200000000,116601172,219535492,19535492,0.09767746
Death Wish,107.0,"Action,Crime,Drama",6.4,50279,30000000,34017028,48575965,18575965,0.6191988333333334
300: Rise of an Empire,102.0,"Action,Fantasy,War",6.2,262978,110000000,106580051,330780051,220780051,2.0070913727272726
The Man with the Iron Fists,95.0,Action,5.4,58185,15000000,15634090,22018988,7018988,0.46793253333333334
47 Ronin,128.0,"Action,Adventure,Drama",6.3,135754,175000000,38362475,151716815,-23283185,-0.13304677142857144
Bait,93.0,"Action,Adventure,Drama",5.2,14627,35000000,15325127,15471969,-19528031,-0.5579437428571429
The Next Three Days,133.0,"Action,Crime,Drama",7.4,168066,30000000,21148651,67255916,37255916,1.2418638666666666
Hobo with a Shotgun,86.0,"Action,Comedy,Horror",6.1,41633,3000000,703372,834953,-2165047,-0.7216823333333333
Real Steel,127.0,"Action,Drama,Family",7.1,283534,110000000,85463309,263880341,153880341,1.398912190909091
R.I.P.D.,96.0,"Action,Adventure,Comedy",5.6,109078,130000000,33618855,79076678,-50923322,-0.39171786153846155
Red State,88.0,"Action,Crime,Horror",6.2,59266,4000000,1065429,1983596,-2016404,-0.504101
The World's End,109.0,"Action,Comedy,Sci-Fi",7.0,235308,20000000,26004851,47508505,27508505,1.37542525
Max Steel,92.0,"Action,Adventure,Family",4.6,16788,10000000,3818664,4563080,-5436920,-0.543692
The Mortal Instruments: City of Bones,130.0,"Action,Fantasy,Horror",5.9,121936,60000000,31165421,75965567,15965567,0.26609278333333336
Abduction,106.0,"Action,Mystery,Thriller",5.1,72552,35000000,28087155,86648359,51648359,1.4756674
A Good Day to Die Hard,98.0,"Action,Thriller",5.3,188383,92000000,67349198,304249198,212249198,2.3070565
Edge of Tomorrow,113.0,"Action,Sci-Fi",7.9,546284,178000000,100206256,370541256,192541256,1.0816924494382023
Wrath of the Titans,99.0,"Action,Adventure,Fantasy",5.7,172330,150000000,83670083,305270083,155270083,1.0351338866666666
Divergent,139.0,"Action,Adventure,Mystery",6.7,399703,85000000,150947895,276014965,191014965,2.247234882352941
The Wall,88.0,"Action,Drama,Thriller",6.2,20391,3000000,1803064,4495262,1495262,0.4984206666666667
No Good Deed,84.0,"Action,Crime,Drama",5.6,16045,13200000,52543632,54323210,41123210,3.115394696969697
Lucy,89.0,"Action,Sci-Fi,Thriller",6.4,403194,40000000,126573960,457507776,417507776,10.4376944
Inferno,121.0,"Action,Adventure,Crime",6.2,138978,75000000,34343574,219519367,144519367,1.9269248933333334
Sicario,121.0,"Action,Crime,Drama",7.6,328548,30000000,46889293,84393749,54393749,1.8131249666666667
Red Dawn,93.0,"Action,Sci-Fi,Thriller",5.4,69599,65000000,44806783,48164150,-16835850,-0.2590130769230769
X-Men: First Class,131.0,"Action,Adventure,Sci-Fi",7.7,608930,160000000,146408305,355408305,195408305,1.22130190625
Cop Out,107.0,"Action,Comedy,Crime",5.6,81656,37000000,44875481,55909910,18909910,0.5110786486486486
Ride Along,99.0,"Action,Comedy,Crime",6.2,94529,25000000,134202565,153733800,128733800,5.149352
Man on a Ledge,102.0,"Action,Adventure,Crime",6.6,137507,42000000,18620000,49621440,7621440,0.18146285714285715
Contagion,106.0,"Action,Drama,Thriller",6.6,201536,60000000,75658097,137551594,77551594,1.2925265666666668
Skin Trade,96.0,"Action,Crime,Thriller",5.7,6942,9000000,1242,1242,-8998758,-0.999862
The Dark Tower,95.0,"Action,Adventure,Fantasy",5.7,107518,60000000,50701325,113461527,53461527,0.89102545
Snow White and the Huntsman,127.0,"Action,Adventure,Drama",6.1,258938,170000000,155136755,401021746,231021746,1.3589514470588235
No Escape,103.0,"Action,Thriller",6.8,70222,5000000,27288872,42844516,37844516,7.5689032
The Gunman,115.0,"Action,Crime,Drama",5.8,36053,40000000,10664749,18594227,-21405773,-0.535144325
Jack Reacher: Never Go Back,118.0,"Action,Thriller",6.1,121892,60000000,58697076,159946489,99946489,1.6657748166666666
Yoga Hosers,88.0,"Action,Comedy,Fantasy",4.3,10483,5000000,0,22958,-4977042,-0.9954084
Teenage Mutant Ninja Turtles: Out of the Shadows,112.0,"Action,Adventure,Comedy",6.0,77234,135000000,82051601,245328374,110328374,0.8172472148148148
Red Tails,125.0,"Action,Adventure,Drama",5.9,31815,58000000,49876377,50365498,-7634502,-0.1316293448275862
Captain America: The Winter Soldier,136.0,"Action,Adventure,Sci-Fi",7.8,666252,170000000,259746958,714401889,544401889,3.2023640529411765
Rampage,107.0,"Action,Adventure,Sci-Fi",6.1,115891,120000000,101028233,428056280,308056280,2.5671356666666667
Kung Fu Panda 3,95.0,"Action,Adventure,Animation",7.1,116166,140000000,143528619,517599142,377599142,2.6971367285714285
Red Sparrow,140.0,"Action,Drama,Thriller",6.6,136738,69000000,46874505,145951861,76951861,1.1152443623188406
American Heist,94.0,"Action,Crime,Drama",5.1,15547,10000000,0,2341218,-7658782,-0.7658782
Hardcore Henry,96.0,"Action,Adventure,Sci-Fi",6.7,78226,2000000,9252038,17187434,15187434,7.593717
American Ultra,96.0,"Action,Comedy,Sci-Fi",6.1,76769,28000000,14439985,30295028,2295028,0.08196528571428571
Patriots Day,133.0,"Action,Crime,Drama",7.4,76204,40000000,31886361,52837989,12837989,0.320949725
Hotel Artemis,94.0,"Action,Drama,Sci-Fi",6.1,30586,15000000,6708137,12758799,-2241201,-0.1494134
The Mechanic,93.0,"Action,Crime,Thriller",6.6,141254,42500000,29121498,76347393,33847393,0.7964092470588235
Keanu,100.0,"Action,Comedy,Crime",6.3,41560,15000000,20591853,20688141,5688141,0.3792094
Free Fire,91.0,"Action,Comedy,Crime",6.4,35954,10000000,1799322,3793739,-6206261,-0.6206261
Trapped,105.0,"Action,Drama,Thriller",7.6,7683,30000000,6916869,6916869,-23083131,-0.7694377
Adrift,96.0,"Action,Adventure,Biography",6.6,34115,35000000,31445011,57897191,22897191,0.6542054571428572
Green Zone,115.0,"Action,Drama,Thriller",6.8,122132,100000000,35497337,97523020,-2476980,-0.0247698
Repo Men,111.0,"Action,Crime,Sci-Fi",6.3,96144,32000000,13942007,18195238,-13804762,-0.4313988125
Jackass 3D,95.0,"Action,Comedy,Documentary",7.0,53289,20000000,117229692,171685793,151685793,7.58428965
Looper,113.0,"Action,Crime,Drama",7.4,500595,30000000,66486205,170466405,140466405,4.6822135
Iron Man 3,130.0,"Action,Adventure,Sci-Fi",7.2,692794,200000000,408992272,1215392272,1015392272,5.07696136
Cloud Atlas,172.0,"Action,Drama,Mystery",7.4,326473,102000000,27108272,130673154,28673154,0.28110935294117645
"I, Frankenstein",92.0,"Action,Fantasy,Horror",5.1,74910,65000000,19075290,74575290,9575290,0.14731215384615384
Here Comes the Boom,105.0,"Action,Comedy,Sport",6.4,81761,42000000,45290318,73239258,31239258,0.7437918571428571
Destroyer,121.0,"Action,Crime,Drama",6.2,13683,9000000,1533324,3681096,-5318904,-0.5909893333333334
Guardians of the Galaxy,121.0,"Action,Adventure,Comedy",8.1,948394,170000000,333172112,770867516,600867516,3.5345148
Getaway,90.0,"Action,Crime,Thriller",4.4,22157,18000000,10501938,11813989,-6186011,-0.3436672777777778
Skyscraper,102.0,"Action,Adventure,Thriller",5.8,81193,125000000,68420120,304115534,179115534,1.432924272
Megamind,95.0,"Action,Animation,Comedy",7.3,207488,130000000,148415853,321887208,191887208,1.4760554461538462
Jack Ryan: Shadow Recruit,105.0,"Action,Drama,Thriller",6.2,114913,60000000,50577412,131377412,71377412,1.1896235333333334
Suicide Squad,123.0,"Action,Adventure,Fantasy",6.0,533039,175000000,325100054,746059887,571059887,3.2631993542857143
Journey 2: The Mysterious Island,94.0,"Action,Adventure,Comedy",5.8,83507,79000000,103860290,318146162,239146162,3.027166607594937
Battleship,131.0,"Action,Adventure,Sci-Fi",5.8,225342,220000000,65233400,313477717,93477717,0.4248987136363636
Safe House,115.0,"Action,Adventure,Crime",6.8,192655,85000000,126181630,208542162,123542162,1.4534372
Safe,94.0,"Action,Crime,Thriller",6.5,96388,33000000,17142080,41495213,8495213,0.25743069696969695
The Amazing Spider-Man 2,142.0,"Action,Adventure,Sci-Fi",6.6,388363,200000000,202853933,708996336,508996336,2.54498168
The Darkest Minds,104.0,"Action,Adventure,Drama",5.7,21340,34000000,12695691,38361428,4361428,0.12827729411764707
The Fate of the Furious,136.0,"Action,Crime,Thriller",6.7,179774,250000000,225764765,1234846267,984846267,3.939385068
The Hunger Games: Mockingjay - Part 2,137.0,"Action,Adventure,Sci-Fi",6.6,252384,160000000,281723902,648986787,488986787,3.05616741875
Dead Man Down,118.0,"Action,Crime,Drama",6.5,61238,30000000,10895295,19599974,-10400026,-0.34666753333333333
White House Down,131.0,"Action,Drama,Thriller",6.4,191791,150000000,73103784,205440387,55440387,0.36960258
Live by Night,129.0,"Action,Crime,Drama",6.4,47243,65000000,10378555,21774432,-43225568,-0.6650087384615384
Vice,96.0,"Action,Adventure,Sci-Fi",4.2,14436,60000000,47836282,70883171,10883171,0.18138618333333334
Centurion,97.0,"Action,Adventure,Drama",6.4,74085,15000000,123570,7885048,-7114952,-0.47433013333333335
Tomorrowland,130.0,"Action,Adventure,Family",6.4,161343,170000000,93436322,206627518,36627518,0.2154559882352941
Point Break,114.0,"Action,Crime,Sport",5.3,53802,100000000,28782481,126704591,26704591,0.26704591
Big Hero 6,102.0,"Action,Adventure,Animation",7.8,371204,165000000,222527828,652127828,487127828,2.952289866666667
Spider-Man: Homecoming,133.0,"Action,Adventure,Sci-Fi",7.5,426302,175000000,334201140,880166350,705166350,4.029522
X-Men: Apocalypse,144.0,"Action,Adventure,Sci-Fi",7.0,356556,178000000,155442489,542537546,364537546,2.047963741573034
American Made,115.0,"Action,Biography,Comedy",7.2,131043,50000000,51342000,135569212,85569212,1.71138424
Taken 2,92.0,"Action,Thriller",6.3,273106,45000000,139854287,377807404,332807404,7.395720088888889
Hansel & Gretel: Witch Hunters,88.0,"Action,Fantasy,Horror",6.1,183387,50000000,55703475,214949716,164949716,3.29899432
Redemption,100.0,"Action,Crime,Drama",6.2,61317,23000000,36686,13593473,-9406527,-0.4089794347826087
The Hunger Games: Catching Fire,146.0,"Action,Adventure,Sci-Fi",7.5,575455,130000000,424668047,864868047,734868047,5.652831130769231
3 Days to Kill,117.0,"Action,Drama,Thriller",6.2,81681,28000000,30697999,38959900,10959900,0.391425
22 Jump Street,112.0,"Action,Comedy,Crime",7.0,319504,50000000,191719337,331333876,281333876,5.62667752
Need for Speed,132.0,"Action,Crime,Thriller",6.5,154909,66000000,43568507,194169619,128169619,1.9419639242424243
The Magnificent Seven,132.0,"Action,Adventure,Western",6.9,168514,90000000,93432655,162525156,72525156,0.8058350666666667
Nerve,96.0,"Action,Adventure,Crime",6.5,102782,20000000,38583626,70652284,50652284,2.5326142
The Predator,107.0,"Action,Adventure,Sci-Fi",5.4,94888,88000000,51024708,159487563,71487563,0.8123586704545455
The Legend of Tarzan,110.0,"Action,Adventure,Drama",6.3,150154,180000000,126643061,348902025,168902025,0.9383445833333334
The Eagle,114.0,"Action,Adventure,Drama",6.2,61475,25000000,19490041,38993548,13993548,0.55974192
Power Rangers,124.0,"Action,Adventure,Sci-Fi",6.0,92013,120000000,85364450,142531552,22531552,0.18776293333333333
Morgan,92.0,"Action,Horror,Sci-Fi",5.8,35487,8000000,3915251,7298786,-701214,-0.08765175
Pompeii,105.0,"Action,Adventure,Drama",5.5,100467,80000000,23169033,108469033,28469033,0.3558629125
King Arthur: Legend of the Sword,126.0,"Action,Adventure,Drama",6.8,169054,175000000,39175066,139630336,-35369664,-0.2021123657142857
The Angry Birds Movie,97.0,"Action,Animation,Comedy",6.3,69624,73000000,107509366,352327887,279327887,3.826409410958904
Monster Trucks,104.0,"Action,Adventure,Comedy",5.7,13525,125000000,33370166,61642798,-63357202,-0.506857616
Thor: Ragnarok,130.0,"Action,Adventure,Comedy",7.9,482995,180000000,315058289,846980024,666980024,3.7054445777777776
Lone Survivor,121.0,"Action,Biography,Drama",7.5,246641,40000000,125095601,149804632,109804632,2.7451158
Premium Rush,91.0,"Action,Crime,Thriller",6.5,105279,35000000,20275446,31393201,-3606799,-0.1030514
This Means War,103.0,"Action,Comedy,Romance",6.3,167438,65000000,54760791,156974557,91974557,1.4149931846153847
In Time,109.0,"Action,Crime,Drama",6.7,346077,35000000,37553932,165103952,130103952,3.7172557714285714
Stolen,96.0,"Action,Crime,Thriller",5.5,41313,35000000,289773,17967746,-17032254,-0.48663582857142856
End of Watch,109.0,"Action,Crime,Drama",7.6,211308,15000000,41003371,57586606,42586606,2.8391070666666667
Phantom,136.0,"Action,Drama,Thriller",5.8,7739,18000000,1034589,1199510,-16800490,-0.9333605555555555
Captain Underpants: The First Epic Movie,89.0,"Action,Animation,Comedy",6.2,21903,38000000,73921000,126577874,88577874,2.3309966842105263
Taken 3,108.0,"Action,Thriller",6.0,165072,48000000,89256424,327656424,279656424,5.8261755
Plastic,102.0,"Action,Comedy,Crime",6.0,7234,10000000,0,575371,-9424629,-0.9424629
Star Trek Beyond,122.0,"Action,Adventure,Sci-Fi",7.1,209844,185000000,158848340,335802233,150802233,0.8151472054054054
Paul Blart: Mall Cop 2,94.0,"Action,Comedy,Crime",4.4,30828,38000000,71091594,107650646,69650646,1.8329117368421053
Bilal: A New Breed of Hero,105.0,"Action,Adventure,Animation",8.0,16854,30000000,490973,648599,-29351401,-0.9783800333333333
Breaking In,88.0,"Action,Crime,Drama",5.4,10154,6000000,46840590,51411620,45411620,7.568603333333333
Clash of the Titans,106.0,"Action,Adventure,Fantasy",5.8,256176,125000000,163214888,493214888,368214888,2.945719104
Justice League,120.0,"Action,Adventure,Fantasy",6.5,329135,300000000,229024295,655945209,355945209,1.18648403
Hanna,111.0,"Action,Drama,Thriller",6.8,179178,30000000,40259119,65343694,35343694,1.1781231333333333
The Warrior's Way,100.0,"Action,Fantasy,Western",6.3,24271,42000000,5666340,8514325,-33485675,-0.7972779761904762
The Darkest Hour,89.0,"Action,Adventure,Horror",4.9,55071,34800000,21443494,62831715,28031715,0.8055090517241379
Seventh Son,102.0,"Action,Adventure,Fantasy",5.5,66565,95000000,17725785,108874967,13874967,0.14605228421052632
Brick Mansions,90.0,"Action,Crime",5.7,37528,28000000,20396829,73421224,45421224,1.6221865714285715
Oblivion,124.0,"Action,Adventure,Sci-Fi",7.0,453966,120000000,89107235,287916633,167916633,1.399305275
Maleficent,97.0,"Action,Adventure,Family",7.0,305832,180000000,241407328,758536735,578536735,3.2140929722222222
Fast Five,130.0,"Action,Crime,Thriller",7.3,329892,125000000,210031325,630163454,505163454,4.041307632
Blackthorn,102.0,"Action,Adventure,Western",6.6,8553,4500000,200558,1217307,-3282693,-0.7294873333333334
Colombiana,108.0,"Action,Drama,Thriller",6.4,87659,40000000,36665854,72295262,32295262,0.80738155
American Assassin,112.0,"Action,Thriller",6.2,57793,63000000,36249674,68310140,5310140,0.0842879365079365
Transformers: Age of Extinction,165.0,"Action,Adventure,Sci-Fi",5.7,283486,210000000,245439076,1104039076,894039076,4.2573289333333335
Mortdecai,107.0,"Action,Comedy,Crime",5.5,61366,60000000,7696134,30396134,-29603866,-0.4933977666666667
Mandy,121.0,"Action,Fantasy,Horror",6.6,44378,6000000,1214525,1427656,-4572344,-0.7620573333333334
Knight and Day,109.0,"Action,Adventure,Comedy",6.3,169840,117000000,76423035,258751370,141751370,1.211550170940171
The Brothers Grimsby,83.0,"Action,Adventure,Comedy",6.2,82123,35000000,6864016,28720470,-6279530,-0.17941514285714286
The Lone Ranger,150.0,"Action,Adventure,Western",6.4,208827,275000000,89302115,260002115,-14997885,-0.05453776363636364
Ironclad,121.0,"Action,Adventure,Drama",6.2,38477,25000000,0,5297411,-19702589,-0.78810356
Gangster Squad,113.0,"Action,Crime,Drama",6.7,195560,60000000,46000903,104100903,44100903,0.73501505
Tomb Raider,119.0,"Action,Adventure,Fantasy",6.3,163560,90000000,58250803,273477501,183477501,2.0386389
Into the Grizzly Maze,94.0,"Action,Adventure,Drama",5.3,7006,10000000,0,0,-10000000,-1.0
Alex Cross,101.0,"Action,Crime,Mystery",5.1,30951,35000000,25888412,35426759,426759,0.012193114285714285
Scouts Guide to the Zombie Apocalypse,93.0,"Action,Comedy,Horror",6.3,40479,15000000,3703046,15554855,554855,0.03699033333333333
Ride Along 2,102.0,"Action,Comedy,Crime",5.9,48688,40000000,90862685,124827316,84827316,2.1206829
Heist,93.0,"Action,Crime,Thriller",6.1,24740,35000000,23483357,28906817,-6093183,-0.17409094285714286
Source Code,93.0,"Action,Drama,Sci-Fi",7.5,452036,32000000,54712227,140428499,108428499,3.38839059375
Dhoom 3,172.0,"Action,Thriller",5.4,40466,24000000,8031955,11723620,-12276380,-0.5115158333333333
You're Next,95.0,"Action,Comedy,Horror",6.6,79451,1000000,18494006,26887177,25887177,25.887177
Thor: The Dark World,112.0,"Action,Adventure,Fantasy",6.9,540996,150000000,206362140,644602516,494602516,3.297350106666667
Falcon Rising,103.0,"Action,Adventure",5.8,6955,4500000,11774,11774,-4488226,-0.9973835555555556
The November Man,108.0,"Action,Crime,Thriller",6.3,59293,15000000,25018119,34820335,19820335,1.3213556666666666
The Lego Ninjago Movie,101.0,"Action,Adventure,Animation",6.0,18926,70000000,59281555,122737201,52737201,0.7533885857142857
Sicario: Day of the Soldado,122.0,"Action,Crime,Drama",7.1,95650,35000000,50065850,75885196,40885196,1.168148457142857
Dragon Ball Super: Broly,100.0,"Action,Adventure,Animation",8.0,16465,8500000,30376755,122747755,114247755,13.440912352941176
Sucker Punch,110.0,"Action,Adventure,Fantasy",6.1,218371,75000000,36392502,89758389,14758389,0.19677852
Parker,118.0,"Action,Crime,Thriller",6.2,105529,35000000,17616641,48543388,13543388,0.38695394285714285
Midnight Special,112.0,"Action,Drama,Mystery",6.6,67921,18000000,3712282,7680250,-10319750,-0.5733194444444445
Kingsman: The Secret Service,129.0,"Action,Adventure,Comedy",7.7,544510,94000000,128261724,404561724,310561724,3.3038481276595744
London Has Fallen,99.0,"Action,Thriller",5.9,124757,60000000,62524260,195194085,135194085,2.25323475
Noah,138.0,"Action,Adventure,Drama",5.8,229326,130000000,101200044,352831065,222831065,1.7140851153846153
Jumanji: Welcome to the Jungle,119.0,"Action,Adventure,Comedy",7.0,242735,90000000,404508916,964496193,874496193,9.716624366666666
Ben-Hur,123.0,"Action,Adventure,Drama",5.7,37975,95000000,26410477,91669648,-3330352,-0.03505633684210526
Hitman: Agent 47,96.0,"Action,Adventure,Crime",5.7,80510,35000000,22467450,82182803,47182803,1.3480800857142856
Hot Pursuit,87.0,"Action,Comedy,Crime",5.1,44723,35000000,34580201,45671512,10671512,0.30490034285714285
Allied,124.0,"Action,Drama,Romance",7.1,125741,106000000,40098064,119266661,13266661,0.12515717924528302
Baby Driver,113.0,"Action,Crime,Drama",7.6,363977,34000000,107825862,228104185,194104185,5.708946617647059
Mile 22,94.0,"Action,Adventure,Thriller",6.1,47862,35000000,36108758,66295121,31295121,0.8941463142857143
Dangal,161.0,"Action,Biography,Drama",8.5,123638,9500000,12391761,294654618,285154618,30.01627557894737
Man of Steel,143.0,"Action,Adventure,Sci-Fi",7.1,647288,225000000,291045518,667999518,442999518,1.9688867466666666
Snitch,112.0,"Action,Drama,Thriller",6.5,78142,15000000,42930462,57907734,42907734,2.8605156
Underworld: Blood Wars,91.0,"Action,Adventure,Fantasy",5.8,62942,35000000,30353973,81209222,46209222,1.3202634857142856
Jason Bourne,123.0,"Action,Thriller",6.6,190596,120000000,162192920,416168316,296168316,2.4680693
The Avengers,143.0,"Action,Adventure,Sci-Fi",8.1,1183655,225000000,623279547,1517935897,1292935897,5.746381764444444
The Wolverine,126.0,"Action,Adventure,Sci-Fi",6.7,401286,115000000,132556852,416456852,301456852,2.6213639304347827
"Big Mommas: Like Father, Like Son",107.0,"Action,Comedy,Crime",4.4,23520,32000000,37915414,82332450,50332450,1.5728890625
The Three Musketeers,110.0,"Action,Adventure,Romance",5.8,98408,90000000,20377913,139877913,49877913,0.5541990333333333
The Collection,82.0,"Action,Horror,Thriller",6.1,42256,10000000,6810754,8890094,-1109906,-0.1109906
Incredibles 2,118.0,"Action,Adventure,Animation",7.7,203510,200000000,608581744,1242520711,1042520711,5.212603555
Maze Runner: The Scorch Trials,131.0,"Action,Sci-Fi,Thriller",6.3,201143,61000000,81697192,310566162,249566162,4.09124855737705
Sultan,170.0,"Action,Drama,Sport",7.1,33371,11000000,5599781,72989781,61989781,5.6354346363636365
Dunkirk,106.0,"Action,Drama,History",7.9,466580,150000000,190068280,499837368,349837368,2.33224912
The Accountant,128.0,"Action,Crime,Drama",7.3,233022,40000000,86260045,152962083,112962083,2.824052075
Wild Card,92.0,"Action,Crime,Drama",5.6,46463,30000000,3200,4315789,-25684211,-0.8561403666666667
The Mummy,110.0,"Action,Adventure,Fantasy",5.5,154345,195000000,80101125,409953905,214953905,1.1023277179487179
Left Behind,110.0,"Action,Drama,Fantasy",3.1,33515,18500000,4221341,4221341,-14278659,-0.7718194054054054
John Wick,101.0,"Action,Crime,Thriller",7.4,449942,30000000,43037835,76235001,46235001,1.5411667
The Transporter Refueled,96.0,"Action,Adventure,Crime",5.2,36201,22000000,16029670,69698495,47698495,2.168113409090909
The A-Team,117.0,"Action,Adventure,Thriller",6.8,235256,110000000,77222099,177241171,67241171,0.6112833727272727
The Hunger Games: Mockingjay - Part 1,123.0,"Action,Adventure,Sci-Fi",6.6,379050,125000000,337135885,766575131,641575131,5.132601048
Forsaken,90.0,"Action,Drama,Western",6.3,9199,18000000,0,0,-18000000,-1.0
Spectre,148.0,"Action,Adventure,Thriller",6.8,352504,300000000,200074175,879620923,579620923,1.9320697433333334
Pacific Rim: Uprising,111.0,"Action,Adventure,Sci-Fi",5.6,89462,155000000,59874525,290930148,135930148,0.8769686967741935
Predators,107.0,"Action,Adventure,Sci-Fi",6.4,199764,40000000,52000688,127234389,87234389,2.180859725
Aquaman,143.0,"Action,Adventure,Fantasy",7.1,263328,160000000,335061807,1146894640,986894640,6.1680915
5 Days of War,113.0,"Action,Drama,War",5.6,13089,12000000,17479,87793,-11912207,-0.9926839166666667
The Last Stand,107.0,"Action,Thriller",6.4,126623,30000000,12050299,48330757,18330757,0.6110252333333334
Pirates of the Caribbean: Dead Men Tell No Tales,129.0,"Action,Adventure,Fantasy",6.6,228592,230000000,172558876,788241137,558241137,2.4271353782608696
The Nice Guys,116.0,"Action,Comedy,Crime",7.4,240337,50000000,36261763,59596747,9596747,0.19193494
Robin Hood,116.0,"Action,Adventure,Thriller",5.3,41588,210000000,105487148,322459006,112459006,0.5355190761904762
Robin Hood,140.0,"Action,Adventure,Drama",6.6,239480,210000000,105487148,322459006,112459006,0.5355190761904762
Dylan Dog: Dead of Night,107.0,"Action,Comedy,Crime",5.1,14120,20000000,1186538,6093725,-13906275,-0.69531375
Star Trek Into Darkness,132.0,"Action,Adventure,Sci-Fi",7.7,445535,190000000,228778661,467381584,277381584,1.4599030736842105
Jupiter Ascending,127.0,"Action,Adventure,Sci-Fi",5.3,166327,179000000,47482519,181982519,2982519,0.016662117318435754
Independence Day: Resurgence,120.0,"Action,Adventure,Sci-Fi",5.2,155344,165000000,103144286,384169424,219169424,1.3282995393939394
Ready Player One,140.0,"Action,Adventure,Sci-Fi",7.5,301660,150000000,137690172,579290136,429290136,2.86193424
The Losers,97.0,"Action,Adventure,Crime",6.4,83876,25000000,23591432,29863840,4863840,0.1945536
Jane Got a Gun,98.0,"Action,Drama,Western",5.9,19051,25000000,1513793,3771345,-21228655,-0.8491462
Homefront,100.0,"Action,Thriller",6.5,98549,22000000,20158492,51695362,29695362,1.3497891818181817
Takers,107.0,"Action,Crime,Thriller",6.2,53377,32000000,57744720,70587268,38587268,1.205852125
How to Train Your Dragon 2,102.0,"Action,Adventure,Animation",7.8,278205,145000000,177002924,614586270,469586270,3.238526
The Expendables 2,103.0,"Action,Adventure,Thriller",6.6,277584,100000000,85028192,311979256,211979256,2.11979256
The Maze Runner,113.0,"Action,Mystery,Sci-Fi",6.8,387038,34000000,102427862,348319861,314319861,9.244701794117647
Baahubali 2: The Conclusion,167.0,"Action,Drama",8.3,65656,30000000,18985794,263502914,233502914,7.783430466666666
Skyfall,143.0,"Action,Adventure,Thriller",7.8,592221,200000000,304360277,1110526981,910526981,4.552634905
Doctor Strange,115.0,"Action,Adventure,Fantasy",7.5,514510,165000000,232641920,676404566,511404566,3.099421612121212
The Tourist,103.0,"Action,Adventure,Thriller",6.0,206714,100000000,67631157,278731369,178731369,1.78731369
Rise of the Planet of the Apes,105.0,"Action,Drama,Sci-Fi",7.6,473020,93000000,176760185,470986200,377986200,4.064367741935484
Transformers: Dark of the Moon,154.0,"Action,Adventure,Sci-Fi",6.2,366409,195000000,352390543,1123790543,928790543,4.763028425641026
G.I. Joe: Retaliation,110.0,"Action,Adventure,Sci-Fi",5.8,165536,140000000,122523060,375740705,235740705,1.6838621785714285
Lockout,95.0,"Action,Sci-Fi,Thriller",6.1,89554,20000000,14326865,33943049,13943049,0.69715245
The Lego Batman Movie,104.0,"Action,Animation,Comedy",7.3,116433,80000000,175750384,310660018,230660018,2.883250225
The Hurricane Heist,103.0,"Action,Adventure,Crime",5.1,15326,40000000,6115824,30963684,-9036316,-0.2259079
Deadpool 2,119.0,"Action,Adventure,Comedy",7.8,391735,110000000,324591735,786680557,676680557,6.151641427272727
Bright,117.0,"Action,Crime,Fantasy",6.4,147834,90000000,0,0,-90000000,-1.0
Cold Pursuit,119.0,"Action,Crime,Drama",6.2,27648,60000000,32138862,62599159,2599159,0.04331931666666667
Foodfight!,91.0,"Action,Animation,Comedy",1.9,8248,45000000,0,73706,-44926294,-0.9983620888888889
RED 2,116.0,"Action,Comedy,Crime",6.6,148846,84000000,53262560,141507355,57507355,0.6846113690476191
Hellboy,120.0,"Action,Adventure,Fantasy",5.4,19534,60000000,59623958,99823958,39823958,0.6637326333333333
Blackhat,133.0,"Action,Crime,Thriller",5.4,48427,70000000,8005980,19665004,-50334996,-0.7190713714285715
I Am Wrath,92.0,"Action,Crime,Drama",5.4,11198,18000000,0,309608,-17690392,-0.9827995555555555
The Sweeney,112.0,"Action,Crime,Drama",6.1,18095,4500000,26345,8000366,3500366,0.7778591111111111
The Adventures of Tintin,107.0,"Action,Adventure,Animation",7.3,202430,130000000,77591831,373993951,243993951,1.8768765461538461
xXx: Return of Xander Cage,107.0,"Action,Adventure,Thriller",5.2,77976,85000000,44898413,345033359,260033359,3.059215988235294
In the Heart of the Sea,122.0,"Action,Adventure,Biography",6.9,108628,100000000,25020758,89693309,-10306691,-0.10306691
Rise of the Guardians,97.0,"Action,Adventure,Animation",7.3,145281,145000000,103412758,306900902,161900902,1.1165579448275862
Killer Elite,116.0,"Action,Crime,Thriller",6.5,117711,70000000,25124986,65409046,-4590954,-0.06558505714285714
Hands of Stone,111.0,"Action,Biography,Drama",6.6,12851,20000000,4712792,5031975,-14968025,-0.74840125
The Meg,113.0,"Action,Horror,Sci-Fi",5.7,114042,178000000,145443742,529530715,351530715,1.9748916573033708
Kung Fu Panda 2,90.0,"Action,Adventure,Animation",7.2,228465,150000000,165249063,664837547,514837547,3.4322503133333333
The Cold Light of Day,93.0,"Action,Thriller",4.9,33039,20000000,3763583,25361206,5361206,0.2680603
Riddick,119.0,"Action,Adventure,Sci-Fi",6.4,144821,38000000,42025135,94763758,56763758,1.4937831052631578
Deadpool,108.0,"Action,Adventure,Comedy",8.0,820847,58000000,363070709,801025593,743025593,12.810786086206896
Contraband,109.0,"Action,Crime,Drama",6.5,111709,25000000,66528000,98406855,73406855,2.9362742
Elysium,109.0,"Action,Drama,Sci-Fi",6.6,395572,120000000,93050117,286192091,166192091,1.3849340916666666
The Son of No One,90.0,"Action,Crime,Drama",5.1,15743,15000000,30680,1148578,-13851422,-0.9234281333333333
The Young and Prodigious T.S. Spivet,105.0,"Action,Adventure,Comedy",7.1,15372,33000000,176847,357687,-32642313,-0.989161
Dawn of the Planet of the Apes,130.0,"Action,Adventure,Drama",7.6,390199,170000000,208545589,710644566,540644566,3.1802621529411765
Run All Night,114.0,"Action,Drama,Thriller",6.6,94131,50000000,26461644,66961644,16961644,0.33923288
The Purge: Anarchy,103.0,"Action,Horror,Sci-Fi",6.5,126203,9000000,71562550,111534881,102534881,11.392764555555555
Mechanic: Resurrection,98.0,"Action,Adventure,Thriller",5.7,67275,40000000,21218403,109738840,69738840,1.743471
World War Z,116.0,"Action,Adventure,Horror",7.0,553751,190000000,202359711,531514650,341514650,1.7974455263157896
Godzilla,123.0,"Action,Adventure,Sci-Fi",6.4,350687,160000000,200676069,529076069,369076069,2.30672543125
USS Indianapolis: Men of Courage,128.0,"Action,Drama,History",5.2,9453,40000000,0,1663785,-38336215,-0.958405375
Olympus Has Fallen,119.0,"Action,Thriller",6.5,235443,70000000,98927592,172878928,102878928,1.4696989714285715
Atomic Blonde,115.0,"Action,Mystery,Thriller",6.7,150407,30000000,51573925,98345423,68345423,2.2781807666666665
Baahubali: The Beginning,159.0,"Action,Drama",8.1,93243,40000000,6738000,26736665,-13263335,-0.331583375
Now You See Me 2,129.0,"Action,Adventure,Comedy",6.5,216219,90000000,65075540,328325007,238325007,2.648055633333333
Transformers: The Last Knight,154.0,"Action,Adventure,Sci-Fi",5.2,119007,217000000,130168683,602893340,385893340,1.7783103225806451
Pound of Flesh,104.0,"Action,Thriller",5.2,5511,7500000,0,0,-7500000,-1.0
Captain America: Civil War,147.0,"Action,Adventure,Sci-Fi",7.8,583507,250000000,408084349,1140069413,890069413,3.560277652
Killers,100.0,"Action,Comedy,Romance",5.4,82237,75000000,47059963,95572749,20572749,0.27430332
Inception,148.0,"Action,Adventure,Sci-Fi",8.8,1841066,160000000,292576195,835524642,675524642,4.2220290125
The Hunger Games,142.0,"Action,Adventure,Sci-Fi",7.2,795227,80000000,408010692,677923379,597923379,7.4740422375
Machine Gun Preacher,129.0,"Action,Biography,Crime",6.8,60074,30000000,538690,3721988,-26278012,-0.8759337333333334
Brothers,156.0,"Action,Drama,Sport",6.7,10689,26000000,28544157,45043870,19043870,0.7324565384615385
Kubo and the Two Strings,101.0,"Action,Adventure,Animation",7.8,105578,55000000,48023088,77548122,22548122,0.40996585454545453
Sleight,89.0,"Action,Drama,Sci-Fi",5.9,7074,250000,3930990,3934450,3684450,14.7378
Kin,102.0,"Action,Drama,Sci-Fi",5.7,9048,30000000,5718096,10096821,-19903179,-0.6634393
Pain & Gain,129.0,"Action,Comedy,Crime",6.4,187820,26000000,49875291,81275291,55275291,2.125972730769231
Collide,99.0,"Action,Crime,Thriller",5.7,13288,29200000,2280004,5466698,-23733302,-0.8127843150684931
Criminal,113.0,"Action,Crime,Drama",6.3,51666,31500000,14708696,38771262,7271262,0.23083371428571428
Survivor,96.0,"Action,Crime,Thriller",5.6,28614,20000000,0,1703281,-18296719,-0.91483595
Logan,137.0,"Action,Drama,Sci-Fi",8.1,560270,127000000,226277068,615461394,488461394,3.846152708661417
Upgrade,100.0,"Action,Sci-Fi,Thriller",7.6,104978,3000000,11977130,16553285,13553285,4.517761666666667
The Equalizer,132.0,"Action,Crime,Thriller",7.2,302302,55000000,101530738,192903624,137903624,2.507338618181818
The Rover,103.0,"Action,Crime,Drama",6.4,40576,8500000,1109199,3180252,-5319748,-0.625852705882353
Avengers: Age of Ultron,141.0,"Action,Adventure,Sci-Fi",7.3,665594,330600000,459005868,1403013963,1072413963,3.2438413883847548
Everest,121.0,"Action,Adventure,Biography",7.1,181133,65000000,43482270,221297061,156297061,2.404570169230769
War for the Planet of the Apes,140.0,"Action,Adventure,Drama",7.5,201943,152000000,146880162,489592267,337592267,2.2210017565789473
Resident Evil: Afterlife,96.0,"Action,Adventure,Horror",5.9,153270,57500000,60128566,295874190,238374190,4.145638086956522
Kick-Ass,117.0,"Action,Comedy",7.6,497363,28000000,48071303,97531134,69531134,2.4832547857142857
Cats & Dogs: The Revenge of Kitty Galore,82.0,"Action,Comedy,Family",4.3,12642,85000000,43585753,113026383,28026383,0.32972215294117646
Teenage Mutant Ninja Turtles,101.0,"Action,Adventure,Comedy",5.8,192220,125000000,191204754,485004754,360004754,2.880038032
Super,96.0,"Action,Comedy,Drama",6.8,70604,2500000,327716,593933,-1906067,-0.7624268
Point Blank,81.0,"Action,Crime,Drama",6.8,12706,3000000,0,0,-3000000,-1.0
Skyline,92.0,"Action,Sci-Fi,Thriller",4.4,83710,10000000,21416355,68264973,58264973,5.8264973
Rogue One: A Star Wars Story,133.0,"Action,Adventure,Sci-Fi",7.8,478592,200000000,532177324,1049102856,849102856,4.24551428
Shazam!,132.0,"Action,Adventure,Comedy",7.4,109051,85000000,139606856,362899733,277899733,3.269408623529412
Ant-Man,117.0,"Action,Adventure,Comedy",7.3,501213,130000000,180202163,518858449,388858449,2.9912188384615384
RoboCop,117.0,"Action,Crime,Sci-Fi",6.2,205798,120000000,58607007,242981799,122981799,1.024848325
Den of Thieves,140.0,"Action,Crime,Drama",7.0,69648,30000000,44947622,80131391,50131391,1.6710463666666666
Ghostbusters,116.0,"Action,Comedy,Fantasy",5.2,186788,144000000,128350574,229008658,85008658,0.5903379027777778
Exodus: Gods and Kings,150.0,"Action,Adventure,Drama",6.0,150858,140000000,65014513,268314513,128314513,0.9165322357142857
One for the Money,91.0,"Action,Comedy,Crime",5.3,38473,42000000,26414527,36197221,-5802779,-0.13816140476190475
Straw Dogs,110.0,"Action,Drama,Thriller",5.8,30924,25000000,10324441,11253821,-13746179,-0.54984716
Non-Stop,106.0,"Action,Mystery,Thriller",7.0,234717,50000000,91742160,222383055,172383055,3.4476611
The Great Wall,103.0,"Action,Adventure,Fantasy",6.0,111602,150000000,45157105,334486852,184486852,1.2299123466666666
The 5th Wave,112.0,"Action,Adventure,Drama",5.2,90788,38000000,34912982,111336398,73336398,1.9299052105263157
Captain America: The First Avenger,124.0,"Action,Adventure,Sci-Fi",6.9,668137,140000000,176654505,370569776,230569776,1.6469269714285715
The Prince,93.0,"Action,Thriller",4.6,16048,18000000,0,0,-18000000,-1.0
2 Guns,109.0,"Action,Comedy,Crime",6.7,182025,61000000,75612460,132493015,71493015,1.1720166393442624
The Other Guys,107.0,"Action,Comedy,Crime",6.7,221664,100000000,119219978,170936470,70936470,0.7093647
Faster,98.0,"Action,Crime,Drama",6.5,93618,24000000,23240020,35792945,11792945,0.49137270833333335
Fantastic Four,100.0,"Action,Adventure,Drama",4.3,140148,120000000,56117548,167849187,47849187,0.398743225
Johnny English Reborn,101.0,"Action,Adventure,Comedy",6.3,110824,45000000,8406711,164640401,119640401,2.6586755777777777
Sabotage,109.0,"Action,Crime,Drama",5.7,55597,35000000,10508518,18376443,-16623557,-0.4749587714285714
Blood Ties,127.0,"Action,Crime,Drama",6.5,17771,26000000,42472,2923959,-23076041,-0.8875400384615385
After Earth,100.0,"Action,Adventure,Drama",4.8,181687,130000000,60522097,251499665,121499665,0.9346128076923077
Chappie,120.0,"Action,Crime,Drama",6.8,213733,49000000,31569268,105002056,56002056,1.1428991020408164
Avengers: Infinity War,149.0,"Action,Adventure,Sci-Fi",8.5,670926,300000000,678815482,2048134200,1748134200,5.827114
Peppermint,101.0,"Action,Crime,Drama",6.5,35854,25000000,35418723,51800758,26800758,1.07203032
The Last Airbender,103.0,"Action,Adventure,Family",4.1,137734,150000000,131772187,319713881,169713881,1.1314258733333333
Geostorm,109.0,"Action,Sci-Fi,Thriller",5.3,78287,100000000,33700160,220796009,120796009,1.20796009
Khiladi 786,141.0,"Action,Comedy",4.4,5648,5600000,385422,14683763,9083763,1.6221005357142857
The Expendables 3,126.0,"Action,Adventure,Thriller",6.1,156432,100000000,39322544,209461378,109461378,1.09461378
Snatched,90.0,"Action,Adventure,Comedy",4.5,29997,42000000,45852178,57852177,15852177,0.37743278571428573
How to Train Your Dragon: The Hidden World,104.0,"Action,Adventure,Animation",7.6,60769,129000000,160791800,519258283,390258283,3.025258007751938
Resident Evil: The Final Chapter,107.0,"Action,Horror,Sci-Fi",5.6,74979,40000000,26844692,314101190,274101190,6.85252975
Game Night,100.0,"Action,Comedy,Crime",7.0,163279,37000000,69179066,117378084,80378084,2.1723806486486485
