movie,runtime_minutes,genres,averagerating,numvotes,production_budget,domestic_gross,worldwide_gross,net_revenue,ROI%
The Legend of Hercules,99.0,"Action,Adventure,Fantasy",4.2,50352,70000000,18848538,58953319,-11046681,-0.15780972857142858
The Adventurer: The Curse of the Midas Box,100.0,"Adventure,Family,Fantasy",5.4,5257,25000000,0,0,-25000000,-1.0
Reign of Assassins,117.0,"Action,Adventure",6.9,6990,14000000,0,11354230,-2645770,-0.18898357142857142
The Revenant,156.0,"Action,Adventure,Biography",8.0,621193,135000000,183637894,532938302,397938302,2.947691125925926
Letters to Juliet,105.0,"Adventure,Comedy,Drama",6.6,86137,30000000,53032453,82148538,52148538,1.7382846
Iron Man 2,124.0,"Action,Adventure,Sci-Fi",7.0,657690,170000000,312433331,621156389,451156389,2.653861111764706
The Host,125.0,"Action,Adventure,Drama",5.9,105633,50000000,26623701,64477051,14477051,0.28954102
The Grey,117.0,"Action,Adventure,Drama",6.8,228798,25000000,51580136,81249176,56249176,2.24996704
The Last Witch Hunter,106.0,"Action,Adventure,Fantasy",6.0,86118,80000000,27367660,130818912,50818912,0.6352364
The Last Days on Mars,98.0,"Adventure,Horror,Sci-Fi",5.5,33137,10600000,24084,261364,-10338636,-0.9753430188679245
The Croods,98.0,"Action,Adventure,Animation",7.2,176699,135000000,187168425,573068425,438068425,3.2449512962962963
Legend of the Guardians: The Owls of Ga'Hoole,97.0,"Action,Adventure,Animation",7.0,73790,100000000,55675313,139716717,39716717,0.39716717
The Expendables,103.0,"Action,Adventure,Thriller",6.5,307897,82000000,103068524,268268174,186268174,2.2715630975609757
Men in Black 3,106.0,"Action,Adventure,Comedy",6.8,309879,215000000,179020854,654213485,439213485,2.042853418604651
Sherlock Holmes: A Game of Shadows,129.0,"Action,Adventure,Crime",7.5,394189,125000000,186848418,535663443,410663443,3.285307544
The Book of Eli,118.0,"Action,Adventure,Drama",6.9,271307,80000000,94835059,158750817,78750817,0.9843852125
Hercules,98.0,"Action,Adventure,Fantasy",6.0,137287,100000000,72688614,243388614,143388614,1.43388614
Pirates of the Caribbean: On Stranger Tides,136.0,"Action,Adventure,Fantasy",6.6,447624,410600000,241063875,1045663875,635063875,1.5466728567949342
Jack the Giant Slayer,114.0,"Adventure,Fantasy",6.3,123127,195000000,65187603,197687603,2687603,0.013782579487179487
Act of Valor,110.0,"Action,Adventure,Drama",6.5,63787,12000000,70012847,82497035,70497035,5.874752916666667
Norm of the North,90.0,"Adventure,Animation,Comedy",3.6,7951,18000000,17062499,30535660,12535660,0.6964255555555555
Trolls,92.0,"Adventure,Animation,Comedy",6.5,63295,125000000,153707064,344150134,219150134,1.753201072
The Hobbit: An Unexpected Journey,169.0,"Adventure,Family,Fantasy",7.9,719629,250000000,303003568,1017003568,767003568,3.068014272
The Amazing Spider-Man,136.0,"Action,Adventure,Sci-Fi",7.0,525632,220000000,262030663,757890267,537890267,2.444955759090909
Admiral,151.0,"Action,Adventure,Biography",7.0,7978,20000000,0,38585047,18585047,0.92925235
Night at the Museum: Secret of the Tomb,98.0,"Adventure,Comedy,Family",6.2,93103,127000000,113746621,353756621,226756621,1.7854852047244094
Godzilla: King of the Monsters,132.0,"Action,Adventure,Fantasy",6.7,36479,170000000,85576941,299276941,129276941,0.7604525941176471
The Twilight Saga: Eclipse,124.0,"Adventure,Drama,Fantasy",5.0,211733,68000000,300531751,706102828,638102828,9.383865117647058
Mad Max: Fury Road,120.0,"Action,Adventure,Sci-Fi",8.1,780910,150000000,153636354,370098020,220098020,1.4673201333333334
A Lonely Place to Die,99.0,"Adventure,Crime,Thriller",6.3,25547,4000000,0,442550,-3557450,-0.8893625
The Lego Movie,100.0,"Action,Adventure,Animation",7.8,304179,60000000,257784718,457729388,397729388,6.628823133333333
The Kid Who Would Be King,120.0,"Action,Adventure,Family",6.0,8044,59000000,16790790,28348446,-30651554,-0.5195178644067796
Paul,104.0,"Adventure,Comedy,Sci-Fi",7.0,220567,40000000,37412945,101162106,61162106,1.52905265
A Walk in the Woods,104.0,"Adventure,Biography,Comedy",6.3,22033,8000000,29499394,37119358,29119358,3.63991975
Due Date,95.0,"Adventure,Comedy",6.5,303523,65000000,100539043,211739043,146739043,2.2575237384615385
Mars Needs Moms,88.0,"Adventure,Animation,Family",5.4,19823,150000000,21392758,39549758,-110450242,-0.7363349466666667
Total Recall,118.0,"Action,Adventure,Mystery",6.3,228460,125000000,58877969,211856088,86856088,0.694848704
Warcraft,123.0,"Action,Adventure,Fantasy",6.9,225557,160000000,47225655,425522281,265522281,1.65951425625
Valerian and the City of a Thousand Planets,137.0,"Action,Adventure,Fantasy",6.5,139792,180000000,40479370,215098356,35098356,0.19499086666666668
Cars 3,102.0,"Adventure,Animation,Comedy",6.8,59408,175000000,152901115,383541369,208541369,1.1916649657142857
Dark Phoenix,113.0,"Action,Adventure,Sci-Fi",6.0,24451,350000000,42762350,149762350,-200237650,-0.5721075714285714
Paddington,95.0,"Adventure,Comedy,Family",7.2,84679,55000000,76223578,258789097,203789097,3.705256309090909
Brave,93.0,"Adventure,Animation,Comedy",7.1,338728,185000000,237282182,554606532,369606532,1.997873145945946
Alvin and the Chipmunks: Chipwrecked,87.0,"Adventure,Animation,Comedy",4.4,28158,80000000,133107389,349088523,269088523,3.3636065375
Pacific Rim,131.0,"Action,Adventure,Sci-Fi",6.9,443667,190000000,101802906,411002906,221002906,1.1631731894736843
X-Men: Days of Future Past,132.0,"Action,Adventure,Sci-Fi",8.0,620079,200000000,233921534,747862775,547862775,2.739313875
Fantastic Beasts: The Crimes of Grindelwald,134.0,"Adventure,Family,Fantasy",6.6,163151,200000000,159555901,652220086,452220086,2.26110043
Jurassic World,124.0,"Action,Adventure,Sci-Fi",7.0,539338,215000000,652270625,1648854864,1433854864,6.669092390697674
John Carter,132.0,"Action,Adventure,Sci-Fi",6.6,241792,275000000,73058679,282778100,7778100,0.028284
The Bourne Legacy,135.0,"Action,Adventure,Thriller",6.7,268678,125000000,113203870,280355920,155355920,1.24284736
Happy Feet Two,100.0,"Adventure,Animation,Comedy",5.9,38396,135000000,64006466,157956466,22956466,0.1700478962962963
Ender's Game,114.0,"Action,Adventure,Fantasy",6.6,211722,110000000,61737191,127983283,17983283,0.16348439090909092
Jurassic World: Fallen Kingdom,128.0,"Action,Adventure,Sci-Fi",6.2,219125,170000000,417719760,1305772799,1135772799,6.681016464705882
A Bad Moms Christmas,104.0,"Adventure,Comedy",5.5,33056,28000000,72110659,127710550,99710550,3.5610910714285713
Wonder Woman,141.0,"Action,Adventure,Fantasy",7.5,487527,150000000,412563408,821133378,671133378,4.47422252
Season of the Witch,95.0,"Action,Adventure,Fantasy",5.4,85777,40000000,24827228,91126600,51126600,1.278165
127 Hours,94.0,"Adventure,Biography,Drama",7.6,323949,18000000,18335230,60217171,42217171,2.345398388888889
Mortal Engines,128.0,"Action,Adventure,Fantasy",6.1,70193,100000000,15951040,85287417,-14712583,-0.14712583
Black Panther,134.0,"Action,Adventure,Sci-Fi",7.3,516148,200000000,700059566,1348258224,1148258224,5.74129112
The Boss Baby,97.0,"Adventure,Animation,Comedy",6.3,93730,125000000,175003033,510878762,385878762,3.087030096
Kingsman: The Golden Circle,141.0,"Action,Adventure,Comedy",6.8,230797,104000000,100234838,408803696,304803696,2.930804769230769
Tangled,100.0,"Adventure,Animation,Comedy",7.8,366366,260000000,200821936,586477240,326477240,1.2556816923076923
Alita: Battle Angel,122.0,"Action,Adventure,Sci-Fi",7.5,88207,170000000,85710210,402976036,232976036,1.3704472705882353
The Smurfs,103.0,"Adventure,Animation,Comedy",5.5,77577,110000000,142614158,563749323,453749323,4.124993845454545
Captain Marvel,123.0,"Action,Adventure,Sci-Fi",7.0,296225,175000000,426525952,1123061550,948061550,5.417494571428572
Conan the Barbarian,113.0,"Action,Adventure,Fantasy",5.2,90834,90000000,21295021,63356133,-26643867,-0.2960429666666667
The Sorcerer's Apprentice,109.0,"Action,Adventure,Family",6.1,143862,160000000,63150991,217986320,57986320,0.3624145
San Andreas,114.0,"Action,Adventure,Drama",6.1,192750,110000000,155190832,456258539,346258539,3.1478049
The BFG,117.0,"Adventure,Family,Fantasy",6.4,69340,140000000,55483770,199646680,59646680,0.4260477142857143
Bumblebee,114.0,"Action,Adventure,Sci-Fi",6.9,94155,102000000,127195589,465195589,363195589,3.560741068627451
Ant-Man and the Wasp,118.0,"Action,Adventure,Comedy",7.1,244024,130000000,216648740,623144660,493144660,3.7934204615384615
Shrek Forever After,93.0,"Adventure,Animation,Comedy",6.3,167532,165000000,238736787,756244673,591244673,3.5833010484848486
Alice in Wonderland,108.0,"Adventure,Family,Fantasy",6.5,358813,200000000,334191110,1025491110,825491110,4.12745555
Into the Storm,89.0,"Action,Adventure,Drama",5.8,60894,50000000,47602194,150429371,100429371,2.00858742
Batman v Superman: Dawn of Justice,151.0,"Action,Adventure,Fantasy",6.5,576909,250000000,330360194,867500281,617500281,2.470001124
Risen,107.0,"Action,Adventure,Drama",6.3,22813,20000000,36880033,46255763,26255763,1.31278815
Solo: A Star Wars Story,135.0,"Action,Adventure,Fantasy",7.0,226243,275000000,213767512,393151347,118151347,0.4296412618181818
Thor,115.0,"Action,Adventure,Fantasy",7.0,683264,150000000,181030624,449326618,299326618,1.9955107866666666
Priest,87.0,"Action,Adventure,Fantasy",5.7,108320,60000000,29136626,84154026,24154026,0.4025671
How to Train Your Dragon,98.0,"Action,Adventure,Animation",8.1,611299,165000000,217581232,494870992,329870992,1.9992181333333334
The East,116.0,"Adventure,Drama,Thriller",6.8,46804,6500000,2274649,3027956,-3472044,-0.5341606153846153
Dumb and Dumber To,109.0,"Adventure,Comedy",5.6,118646,40000000,86208010,156553592,116553592,2.9138398
Muppets Most Wanted,107.0,"Adventure,Comedy,Crime",6.4,29018,55000000,51178893,79312301,24312301,0.44204183636363636
Wild,115.0,"Adventure,Biography,Drama",7.1,110138,15000000,37880356,52460543,37460543,2.4973695333333334
Gods of Egypt,127.0,"Action,Adventure,Fantasy",5.4,95111,140000000,31153464,138836756,-1163244,-0.008308885714285714
Ferdinand,108.0,"Adventure,Animation,Comedy",6.7,40229,111000000,84410380,289847930,178847930,1.6112426126126127
Kong: Skull Island,118.0,"Action,Adventure,Fantasy",6.6,237720,185000000,168052812,561072059,376072059,2.0328219405405403
Swiss Army Man,97.0,"Adventure,Comedy,Drama",7.0,91736,3000000,4210454,5837111,2837111,0.9457036666666667
The Shape of Water,123.0,"Adventure,Drama,Fantasy",7.3,308112,19500000,63859435,195790794,176290794,9.040553538461538
Puss in Boots,90.0,"Action,Adventure,Animation",6.6,133355,130000000,149260504,554987477,424987477,3.2691344384615384
Get Him to the Greek,109.0,"Adventure,Comedy,Music",6.4,161653,40000000,61153526,91455875,51455875,1.286396875
Goosebumps,103.0,"Adventure,Comedy,Family",6.3,72858,58000000,80069458,158905324,100905324,1.7397469655172413
Green Lantern,114.0,"Action,Adventure,Sci-Fi",5.5,252281,200000000,116601172,219535492,19535492,0.09767746
The Hobbit: The Desolation of Smaug,161.0,"Adventure,Fantasy",7.8,565563,250000000,258366855,960366855,710366855,2.84146742
Gulliver's Travels,85.0,"Adventure,Comedy,Family",4.9,61178,112000000,42779261,232017848,120017848,1.0715879285714285
47 Ronin,128.0,"Action,Adventure,Drama",6.3,135754,175000000,38362475,151716815,-23283185,-0.13304677142857144
Bait,93.0,"Action,Adventure,Drama",5.2,14627,35000000,15325127,15471969,-19528031,-0.5579437428571429
The Emoji Movie,86.0,"Adventure,Animation,Comedy",3.2,47294,50000000,86089513,216562312,166562312,3.33124624
Ramona and Beezus,103.0,"Adventure,Comedy,Family",6.6,16086,15000000,26167002,27469621,12469621,0.8313080666666667
The Incredible Burt Wonderstone,100.0,"Adventure,Comedy,Fantasy",5.9,67549,32000000,22537881,27392609,-4607391,-0.14398096875
R.I.P.D.,96.0,"Action,Adventure,Comedy",5.6,109078,130000000,33618855,79076678,-50923322,-0.39171786153846155
Epic,102.0,"Adventure,Animation,Family",6.7,95318,100000000,107518682,262794441,162794441,1.62794441
Hugo,126.0,"Adventure,Drama,Family",7.5,284869,180000000,73864507,180047784,47784,0.00026546666666666665
The Lost City of Z,141.0,"Adventure,Biography,Drama",6.6,66475,30000000,8574339,17121823,-12878177,-0.4292725666666667
Frozen,93.0,"Adventure,Drama,Sport",6.2,62311,150000000,400738009,1272469910,1122469910,7.483132733333333
Frozen,102.0,"Adventure,Animation,Comedy",7.5,516998,150000000,400738009,1272469910,1122469910,7.483132733333333
The Pirates! Band of Misfits,88.0,"Adventure,Animation,Comedy",6.7,41958,55000000,31051126,136143605,81143605,1.4753382727272728
Max Steel,92.0,"Action,Adventure,Family",4.6,16788,10000000,3818664,4563080,-5436920,-0.543692
Wrath of the Titans,99.0,"Action,Adventure,Fantasy",5.7,172330,150000000,83670083,305270083,155270083,1.0351338866666666
Ice Age: Continental Drift,88.0,"Adventure,Animation,Comedy",6.6,175601,95000000,161321843,879765137,784765137,8.26068565263158
Divergent,139.0,"Action,Adventure,Mystery",6.7,399703,85000000,150947895,276014965,191014965,2.247234882352941
Dumbo,112.0,"Adventure,Family,Fantasy",6.6,25072,170000000,113883318,345004422,175004422,1.0294377764705882
The Space Between Us,120.0,"Adventure,Drama,Romance",6.4,41031,30000000,7885294,16481405,-13518595,-0.45061983333333333
Smallfoot,96.0,"Adventure,Animation,Comedy",6.7,23295,80000000,83240103,213691277,133691277,1.6711409625
Inferno,121.0,"Action,Adventure,Crime",6.2,138978,75000000,34343574,219519367,144519367,1.9269248933333334
The Night Before,101.0,"Adventure,Comedy,Fantasy",6.4,58455,25000000,43035725,52427346,27427346,1.09709384
The Muppets,103.0,"Adventure,Comedy,Family",7.1,82752,45000000,88625922,160971922,115971922,2.5771538222222223
X-Men: First Class,131.0,"Action,Adventure,Sci-Fi",7.7,608930,160000000,146408305,355408305,195408305,1.22130190625
Winnie the Pooh,63.0,"Adventure,Animation,Comedy",7.2,19605,30000000,26692846,50145607,20145607,0.6715202333333333
Man on a Ledge,102.0,"Action,Adventure,Crime",6.6,137507,42000000,18620000,49621440,7621440,0.18146285714285715
The Dark Tower,95.0,"Action,Adventure,Fantasy",5.7,107518,60000000,50701325,113461527,53461527,0.89102545
Snow White and the Huntsman,127.0,"Action,Adventure,Drama",6.1,258938,170000000,155136755,401021746,231021746,1.3589514470588235
Queen of the Desert,128.0,"Adventure,Biography,Drama",5.7,8529,36000000,0,1578543,-34421457,-0.9561515833333334
Teenage Mutant Ninja Turtles: Out of the Shadows,112.0,"Action,Adventure,Comedy",6.0,77234,135000000,82051601,245328374,110328374,0.8172472148148148
Red Tails,125.0,"Action,Adventure,Drama",5.9,31815,58000000,49876377,50365498,-7634502,-0.1316293448275862
Captain America: The Winter Soldier,136.0,"Action,Adventure,Sci-Fi",7.8,666252,170000000,259746958,714401889,544401889,3.2023640529411765
Rampage,107.0,"Action,Adventure,Sci-Fi",6.1,115891,120000000,101028233,428056280,308056280,2.5671356666666667
Kung Fu Panda 3,95.0,"Action,Adventure,Animation",7.1,116166,140000000,143528619,517599142,377599142,2.6971367285714285
The SpongeBob Movie: Sponge Out of Water,92.0,"Adventure,Animation,Comedy",6.0,43560,74000000,162994032,311013181,237013181,3.2028808243243243
Sherlock Gnomes,86.0,"Adventure,Animation,Comedy",5.1,8030,59000000,43242871,87527651,28527651,0.48351950847457625
Hardcore Henry,96.0,"Action,Adventure,Sci-Fi",6.7,78226,2000000,9252038,17187434,15187434,7.593717
Goosebumps 2: Haunted Halloween,90.0,"Adventure,Comedy,Family",5.6,11459,35000000,46697321,93291478,58291478,1.6654708
Adrift,96.0,"Action,Adventure,Biography",6.6,34115,35000000,31445011,57897191,22897191,0.6542054571428572
Interstellar,169.0,"Adventure,Drama,Sci-Fi",8.6,1299334,165000000,188017894,666379375,501379375,3.038662878787879
Holmes & Watson,90.0,"Adventure,Comedy,Crime",3.8,17661,42000000,30568743,41926605,-73395,-0.0017475
Iron Man 3,130.0,"Action,Adventure,Sci-Fi",7.2,692794,200000000,408992272,1215392272,1015392272,5.07696136
The Reef,94.0,"Adventure,Drama,Horror",5.8,15194,10000000,0,15037867,5037867,0.5037867
Monsters University,104.0,"Adventure,Animation,Comedy",7.3,291887,200000000,268488329,743588329,543588329,2.717941645
The Good Dinosaur,93.0,"Adventure,Animation,Comedy",6.7,91465,187500000,123087120,333771037,146271037,0.7801121973333334
Guardians of the Galaxy,121.0,"Action,Adventure,Comedy",8.1,948394,170000000,333172112,770867516,600867516,3.5345148
Inside Out,95.0,"Adventure,Animation,Comedy",8.2,536181,175000000,356461711,854235992,679235992,3.881348525714286
Into the Woods,125.0,"Adventure,Comedy,Drama",6.0,123577,56200000,128002372,213116401,156916401,2.7921067793594307
Alice Through the Looking Glass,113.0,"Adventure,Family,Fantasy",6.2,79951,170000000,77042381,276928112,106928112,0.628988894117647
Skyscraper,102.0,"Action,Adventure,Thriller",5.8,81193,125000000,68420120,304115534,179115534,1.432924272
"Paul, Apostle of Christ",108.0,"Adventure,Biography,Drama",6.7,5662,5000000,17547999,25529498,20529498,4.1058996
Suicide Squad,123.0,"Action,Adventure,Fantasy",6.0,533039,175000000,325100054,746059887,571059887,3.2631993542857143
Journey 2: The Mysterious Island,94.0,"Action,Adventure,Comedy",5.8,83507,79000000,103860290,318146162,239146162,3.027166607594937
Battleship,131.0,"Action,Adventure,Sci-Fi",5.8,225342,220000000,65233400,313477717,93477717,0.4248987136363636
Safe House,115.0,"Action,Adventure,Crime",6.8,192655,85000000,126181630,208542162,123542162,1.4534372
A Wrinkle in Time,109.0,"Adventure,Family,Fantasy",4.2,34888,103000000,100478608,133401882,30401882,0.29516390291262135
Wreck-It Ralph,101.0,"Adventure,Animation,Comedy",7.7,344496,165000000,189412677,496511521,331511521,2.0091607333333332
The Amazing Spider-Man 2,142.0,"Action,Adventure,Sci-Fi",6.6,388363,200000000,202853933,708996336,508996336,2.54498168
The Darkest Minds,104.0,"Action,Adventure,Drama",5.7,21340,34000000,12695691,38361428,4361428,0.12827729411764707
Early Man,89.0,"Adventure,Animation,Comedy",6.1,15882,50000000,8267544,45285890,-4714110,-0.0942822
On the Road,124.0,"Adventure,Drama,Romance",6.1,37886,25000000,720828,9313302,-15686698,-0.62746792
The Hunger Games: Mockingjay - Part 2,137.0,"Action,Adventure,Sci-Fi",6.6,252384,160000000,281723902,648986787,488986787,3.05616741875
Father Figures,113.0,"Adventure,Comedy,Drama",5.5,14373,25000000,17501244,21038441,-3961559,-0.15846236
Vice,96.0,"Action,Adventure,Sci-Fi",4.2,14436,60000000,47836282,70883171,10883171,0.18138618333333334
The Martian,144.0,"Adventure,Drama,Sci-Fi",8.0,680116,108000000,228433663,655271443,547271443,5.067328175925926
Percy Jackson & the Olympians: The Lightning Thief,118.0,"Adventure,Family,Fantasy",5.9,165108,95000000,88768303,223050874,128050874,1.3479039368421053
Centurion,97.0,"Action,Adventure,Drama",6.4,74085,15000000,123570,7885048,-7114952,-0.47433013333333335
Tomorrowland,130.0,"Action,Adventure,Family",6.4,161343,170000000,93436322,206627518,36627518,0.2154559882352941
Big Hero 6,102.0,"Action,Adventure,Animation",7.8,371204,165000000,222527828,652127828,487127828,2.952289866666667
Spider-Man: Homecoming,133.0,"Action,Adventure,Sci-Fi",7.5,426302,175000000,334201140,880166350,705166350,4.029522
Zootopia,108.0,"Adventure,Animation,Comedy",8.0,383446,150000000,341268248,1019429616,869429616,5.79619744
X-Men: Apocalypse,144.0,"Action,Adventure,Sci-Fi",7.0,356556,178000000,155442489,542537546,364537546,2.047963741573034
Despicable Me 3,89.0,"Adventure,Animation,Comedy",6.3,92580,75000000,264624300,1034727750,959727750,12.79637
The Walk,123.0,"Adventure,Biography,Drama",7.3,109714,35000000,10161183,61492104,26492104,0.7569172571428572
Hunt for the Wilderpeople,101.0,"Adventure,Comedy,Drama",7.9,87532,2500000,5205471,23845533,21345533,8.5382132
Hotel Transylvania 3: Summer Vacation,97.0,"Adventure,Animation,Comedy",6.3,42299,65000000,167500092,527079962,462079962,7.108922492307692
Silence,161.0,"Adventure,Drama,History",7.2,85242,46500000,7100177,23726626,-22773374,-0.48974997849462365
Seeking a Friend for the End of the World,101.0,"Adventure,Comedy,Drama",6.7,102047,10000000,7078738,11766959,1766959,0.1766959
Prometheus,124.0,"Adventure,Mystery,Sci-Fi",7.0,538720,125000000,126477084,402448265,277448265,2.21958612
Zambezia,83.0,"Adventure,Animation,Comedy",5.8,6010,20000000,0,34454336,14454336,0.7227168
The Hunger Games: Catching Fire,146.0,"Action,Adventure,Sci-Fi",7.5,575455,130000000,424668047,864868047,734868047,5.652831130769231
The Magnificent Seven,132.0,"Action,Adventure,Western",6.9,168514,90000000,93432655,162525156,72525156,0.8058350666666667
Mike and Dave Need Wedding Dates,98.0,"Adventure,Comedy,Romance",6.0,74849,33000000,46009673,75898100,42898100,1.2999424242424242
Nerve,96.0,"Action,Adventure,Crime",6.5,102782,20000000,38583626,70652284,50652284,2.5326142
The Predator,107.0,"Action,Adventure,Sci-Fi",5.4,94888,88000000,51024708,159487563,71487563,0.8123586704545455
Peter Rabbit,95.0,"Adventure,Animation,Comedy",6.6,27908,50000000,115234093,347136477,297136477,5.94272954
Aladdin,128.0,"Adventure,Comedy,Family",7.4,57549,182000000,246734314,619234314,437234314,2.4023863406593406
The Legend of Tarzan,110.0,"Action,Adventure,Drama",6.3,150154,180000000,126643061,348902025,168902025,0.9383445833333334
The Eagle,114.0,"Action,Adventure,Drama",6.2,61475,25000000,19490041,38993548,13993548,0.55974192
Power Rangers,124.0,"Action,Adventure,Sci-Fi",6.0,92013,120000000,85364450,142531552,22531552,0.18776293333333333
Storks,87.0,"Adventure,Animation,Comedy",6.8,50448,70000000,72679278,183353431,113353431,1.6193347285714286
The Nut Job,85.0,"Adventure,Animation,Comedy",5.7,24587,30000000,64251538,122529966,92529966,3.0843322
Pompeii,105.0,"Action,Adventure,Drama",5.5,100467,80000000,23169033,108469033,28469033,0.3558629125
King Arthur: Legend of the Sword,126.0,"Action,Adventure,Drama",6.8,169054,175000000,39175066,139630336,-35369664,-0.2021123657142857
Coco,105.0,"Adventure,Animation,Comedy",8.4,277194,175000000,209726015,798008101,623008101,3.5600462914285713
The Peanuts Movie,88.0,"Adventure,Animation,Comedy",7.1,39149,99000000,130178411,250091610,151091610,1.5261778787878788
Monster Trucks,104.0,"Action,Adventure,Comedy",5.7,13525,125000000,33370166,61642798,-63357202,-0.506857616
Thor: Ragnarok,130.0,"Action,Adventure,Comedy",7.9,482995,180000000,315058289,846980024,666980024,3.7054445777777776
Cars 2,106.0,"Adventure,Animation,Comedy",6.2,138914,200000000,191450875,560155383,360155383,1.800776915
Free Birds,91.0,"Adventure,Animation,Comedy",5.9,20934,55000000,55750480,110387072,55387072,1.0070376727272727
Percy Jackson: Sea of Monsters,106.0,"Adventure,Family,Fantasy",5.8,102313,90000000,68559554,200859554,110859554,1.2317728222222222
The Green Inferno,100.0,"Adventure,Horror",5.3,33239,1000000,7192291,12931420,11931420,11.93142
Star Trek Beyond,122.0,"Action,Adventure,Sci-Fi",7.1,209844,185000000,158848340,335802233,150802233,0.8151472054054054
Thunder and the House of Magic,85.0,"Adventure,Animation,Comedy",6.3,5626,34000000,4091,62582520,28582520,0.8406623529411764
Bilal: A New Breed of Hero,105.0,"Action,Adventure,Animation",8.0,16854,30000000,490973,648599,-29351401,-0.9783800333333333
Clash of the Titans,106.0,"Action,Adventure,Fantasy",5.8,256176,125000000,163214888,493214888,368214888,2.945719104
Justice League,120.0,"Action,Adventure,Fantasy",6.5,329135,300000000,229024295,655945209,355945209,1.18648403
The Darkest Hour,89.0,"Action,Adventure,Horror",4.9,55071,34800000,21443494,62831715,28031715,0.8055090517241379
Seventh Son,102.0,"Action,Adventure,Fantasy",5.5,66565,95000000,17725785,108874967,13874967,0.14605228421052632
Oblivion,124.0,"Action,Adventure,Sci-Fi",7.0,453966,120000000,89107235,287916633,167916633,1.399305275
Maleficent,97.0,"Action,Adventure,Family",7.0,305832,180000000,241407328,758536735,578536735,3.2140929722222222
Oz the Great and Powerful,130.0,"Adventure,Family,Fantasy",6.3,192045,200000000,234770996,490359051,290359051,1.451795255
Blackthorn,102.0,"Action,Adventure,Western",6.6,8553,4500000,200558,1217307,-3282693,-0.7294873333333334
Transformers: Age of Extinction,165.0,"Action,Adventure,Sci-Fi",5.7,283486,210000000,245439076,1104039076,894039076,4.2573289333333335
Rio 2,101.0,"Adventure,Animation,Comedy",6.3,72209,130000000,131538435,492846291,362846291,2.7911253153846154
Alvin and the Chipmunks: The Road Chip,92.0,"Adventure,Animation,Comedy",5.1,14507,90000000,85886987,249517956,159517956,1.7724217333333334
Moana,107.0,"Adventure,Animation,Comedy",7.6,224253,150000000,248757044,637517365,487517365,3.2501157666666667
Knight and Day,109.0,"Action,Adventure,Comedy",6.3,169840,117000000,76423035,258751370,141751370,1.211550170940171
The Smurfs 2,105.0,"Adventure,Animation,Comedy",5.4,34229,110000000,71017784,348547523,238547523,2.1686138454545456
Earth to Echo,91.0,"Adventure,Family,Sci-Fi",5.8,17627,13000000,38934842,42174545,29174545,2.2441957692307692
The Grand Budapest Hotel,99.0,"Adventure,Comedy,Crime",8.1,633604,31000000,59076019,163981261,132981261,4.289718096774194
The Brothers Grimsby,83.0,"Action,Adventure,Comedy",6.2,82123,35000000,6864016,28720470,-6279530,-0.17941514285714286
The Lone Ranger,150.0,"Action,Adventure,Western",6.4,208827,275000000,89302115,260002115,-14997885,-0.05453776363636364
Ironclad,121.0,"Action,Adventure,Drama",6.2,38477,25000000,0,5297411,-19702589,-0.78810356
Tomb Raider,119.0,"Action,Adventure,Fantasy",6.3,163560,90000000,58250803,273477501,183477501,2.0386389
Into the Grizzly Maze,94.0,"Action,Adventure,Drama",5.3,7006,10000000,0,0,-10000000,-1.0
Minions,91.0,"Adventure,Animation,Comedy",6.4,193917,74000000,336045770,1160336173,1086336173,14.680218554054054
Thor: The Dark World,112.0,"Action,Adventure,Fantasy",6.9,540996,150000000,206362140,644602516,494602516,3.297350106666667
Identity Thief,111.0,"Adventure,Comedy,Crime",5.7,115624,35000000,134506920,175361578,140361578,4.0103308
Falcon Rising,103.0,"Action,Adventure",5.8,6955,4500000,11774,11774,-4488226,-0.9973835555555556
Bone Tomahawk,132.0,"Adventure,Drama,Horror",7.1,70298,2000000,0,475846,-1524154,-0.762077
The Lego Ninjago Movie,101.0,"Action,Adventure,Animation",6.0,18926,70000000,59281555,122737201,52737201,0.7533885857142857
Dragon Ball Super: Broly,100.0,"Action,Adventure,Animation",8.0,16465,8500000,30376755,122747755,114247755,13.440912352941176
Sanctum,108.0,"Adventure,Drama,Thriller",5.9,51318,30000000,23209310,108957098,78957098,2.631903266666667
Sucker Punch,110.0,"Action,Adventure,Fantasy",6.1,218371,75000000,36392502,89758389,14758389,0.19677852
Kingsman: The Secret Service,129.0,"Action,Adventure,Comedy",7.7,544510,94000000,128261724,404561724,310561724,3.3038481276595744
Max,111.0,"Adventure,Drama,Family",6.8,23976,20000000,42656255,43658157,23658157,1.18290785
Noah,138.0,"Action,Adventure,Drama",5.8,229326,130000000,101200044,352831065,222831065,1.7140851153846153
Home,94.0,"Adventure,Animation,Comedy",6.6,85831,130000000,177397510,385997896,255997896,1.9692145846153846
Jumanji: Welcome to the Jungle,119.0,"Action,Adventure,Comedy",7.0,242735,90000000,404508916,964496193,874496193,9.716624366666666
Ben-Hur,123.0,"Action,Adventure,Drama",5.7,37975,95000000,26410477,91669648,-3330352,-0.03505633684210526
Hitman: Agent 47,96.0,"Action,Adventure,Crime",5.7,80510,35000000,22467450,82182803,47182803,1.3480800857142856
American Honey,163.0,"Adventure,Drama,Romance",7.0,31663,3500000,663247,2611750,-888250,-0.2537857142857143
Mile 22,94.0,"Action,Adventure,Thriller",6.1,47862,35000000,36108758,66295121,31295121,0.8941463142857143
The Nutcracker and the Four Realms,99.0,"Adventure,Family,Fantasy",5.5,18734,132900000,54858851,170293899,37393899,0.281368690744921
Man of Steel,143.0,"Action,Adventure,Sci-Fi",7.1,647288,225000000,291045518,667999518,442999518,1.9688867466666666
The Boxtrolls,96.0,"Adventure,Animation,Comedy",6.8,50763,60000000,50837305,111946251,51946251,0.86577085
Mr. Peabody & Sherman,92.0,"Adventure,Animation,Comedy",6.8,57277,145000000,111506430,269806430,124806430,0.860734
Underworld: Blood Wars,91.0,"Action,Adventure,Fantasy",5.8,62942,35000000,30353973,81209222,46209222,1.3202634857142856
The Avengers,143.0,"Action,Adventure,Sci-Fi",8.1,1183655,225000000,623279547,1517935897,1292935897,5.746381764444444
Monte Carlo,109.0,"Adventure,Comedy,Family",5.8,38731,20000000,23186769,39686769,19686769,0.98433845
Rango,107.0,"Adventure,Animation,Comedy",7.2,215761,135000000,123477607,245724600,110724600,0.8201822222222223
The Wolverine,126.0,"Action,Adventure,Sci-Fi",6.7,401286,115000000,132556852,416456852,301456852,2.6213639304347827
The Three Musketeers,110.0,"Action,Adventure,Romance",5.8,98408,90000000,20377913,139877913,49877913,0.5541990333333333
The Little Prince,108.0,"Adventure,Animation,Drama",7.7,50015,77500000,1311213,102028919,24528919,0.3165021806451613
Incredibles 2,118.0,"Action,Adventure,Animation",7.7,203510,200000000,608581744,1242520711,1042520711,5.212603555
Trash,114.0,"Adventure,Crime,Drama",7.2,18690,12000000,17484,6553186,-5446814,-0.4539011666666667
The Mummy,110.0,"Action,Adventure,Fantasy",5.5,154345,195000000,80101125,409953905,214953905,1.1023277179487179
"As Above, So Below",93.0,"Adventure,Horror,Mystery",6.2,66892,5000000,21222315,41824066,36824066,7.3648132
The Transporter Refueled,96.0,"Action,Adventure,Crime",5.2,36201,22000000,16029670,69698495,47698495,2.168113409090909
The A-Team,117.0,"Action,Adventure,Thriller",6.8,235256,110000000,77222099,177241171,67241171,0.6112833727272727
Toy Story 3,103.0,"Adventure,Animation,Comedy",8.3,682218,200000000,415004880,1068879522,868879522,4.34439761
The Hunger Games: Mockingjay - Part 1,123.0,"Action,Adventure,Sci-Fi",6.6,379050,125000000,337135885,766575131,641575131,5.132601048
Spectre,148.0,"Action,Adventure,Thriller",6.8,352504,300000000,200074175,879620923,579620923,1.9320697433333334
Pacific Rim: Uprising,111.0,"Action,Adventure,Sci-Fi",5.6,89462,155000000,59874525,290930148,135930148,0.8769686967741935
The Secret Life of Pets,87.0,"Adventure,Animation,Comedy",6.5,161997,75000000,368384330,886750534,811750534,10.823340453333333
Jem and the Holograms,118.0,"Adventure,Drama,Family",4.1,6683,5000000,2184640,2368937,-2631063,-0.5262126
Life of Pi,127.0,"Adventure,Drama,Fantasy",7.9,535836,120000000,124987022,620912003,500912003,4.174266691666666
Predators,107.0,"Action,Adventure,Sci-Fi",6.4,199764,40000000,52000688,127234389,87234389,2.180859725
Aquaman,143.0,"Action,Adventure,Fantasy",7.1,263328,160000000,335061807,1146894640,986894640,6.1680915
Vacation,99.0,"Adventure,Comedy",6.1,87582,31000000,58884188,102306500,71306500,2.300209677419355
Mirror Mirror,106.0,"Adventure,Comedy,Drama",5.6,79510,85000000,64935167,173613482,88613482,1.0425115529411764
Moonrise Kingdom,94.0,"Adventure,Comedy,Drama",7.8,291750,16000000,45512466,68848446,52848446,3.303027875
Pirates of the Caribbean: Dead Men Tell No Tales,129.0,"Action,Adventure,Fantasy",6.6,228592,230000000,172558876,788241137,558241137,2.4271353782608696
Robin Hood,116.0,"Action,Adventure,Thriller",5.3,41588,210000000,105487148,322459006,112459006,0.5355190761904762
Robin Hood,140.0,"Action,Adventure,Drama",6.6,239480,210000000,105487148,322459006,112459006,0.5355190761904762
The Sisters Brothers,122.0,"Adventure,Comedy,Crime",7.0,32135,38000000,3143056,13143056,-24856944,-0.6541301052631578
Star Trek Into Darkness,132.0,"Action,Adventure,Sci-Fi",7.7,445535,190000000,228778661,467381584,277381584,1.4599030736842105
Rio,96.0,"Adventure,Animation,Comedy",6.9,191621,90000000,143619809,487519809,397519809,4.416886766666667
Jupiter Ascending,127.0,"Action,Adventure,Sci-Fi",5.3,166327,179000000,47482519,181982519,2982519,0.016662117318435754
Independence Day: Resurgence,120.0,"Action,Adventure,Sci-Fi",5.2,155344,165000000,103144286,384169424,219169424,1.3282995393939394
Ready Player One,140.0,"Action,Adventure,Sci-Fi",7.5,301660,150000000,137690172,579290136,429290136,2.86193424
The Losers,97.0,"Action,Adventure,Crime",6.4,83876,25000000,23591432,29863840,4863840,0.1945536
Turbo,96.0,"Adventure,Animation,Comedy",6.4,74639,135000000,83028130,286896578,151896578,1.125159837037037
Smurfs: The Lost Village,90.0,"Adventure,Animation,Comedy",6.0,15612,60000000,45020282,197578586,137578586,2.292976433333333
A Very Harold & Kumar 3D Christmas,90.0,"Adventure,Comedy",6.3,62151,20000000,35061031,36265745,16265745,0.81328725
True Grit,110.0,"Adventure,Drama,Western",7.6,284034,35000000,171243005,252276928,217276928,6.207912228571429
ParaNorman,92.0,"Adventure,Animation,Comedy",7.0,87250,60000000,56003051,108119662,48119662,0.8019943666666667
How to Train Your Dragon 2,102.0,"Action,Adventure,Animation",7.8,278205,145000000,177002924,614586270,469586270,3.238526
The Expendables 2,103.0,"Action,Adventure,Thriller",6.6,277584,100000000,85028192,311979256,211979256,2.11979256
Lean on Pete,121.0,"Adventure,Drama",7.2,8607,8000000,1163056,2455027,-5544973,-0.693121625
Skyfall,143.0,"Action,Adventure,Thriller",7.8,592221,200000000,304360277,1110526981,910526981,4.552634905
Doctor Strange,115.0,"Action,Adventure,Fantasy",7.5,514510,165000000,232641920,676404566,511404566,3.099421612121212
The Tourist,103.0,"Action,Adventure,Thriller",6.0,206714,100000000,67631157,278731369,178731369,1.78731369
Transformers: Dark of the Moon,154.0,"Action,Adventure,Sci-Fi",6.2,366409,195000000,352390543,1123790543,928790543,4.763028425641026
G.I. Joe: Retaliation,110.0,"Action,Adventure,Sci-Fi",5.8,165536,140000000,122523060,375740705,235740705,1.6838621785714285
The Hurricane Heist,103.0,"Action,Adventure,Crime",5.1,15326,40000000,6115824,30963684,-9036316,-0.2259079
Deadpool 2,119.0,"Action,Adventure,Comedy",7.8,391735,110000000,324591735,786680557,676680557,6.151641427272727
The Secret Life of Walter Mitty,114.0,"Adventure,Comedy,Drama",7.3,275300,91000000,58236838,187861183,96861183,1.0644086043956045
Nebraska,115.0,"Adventure,Comedy,Drama",7.7,105304,12000000,17654912,24761360,12761360,1.0634466666666667
Penguins of Madagascar,92.0,"Adventure,Animation,Comedy",6.7,72551,132000000,83350911,366942531,234942531,1.779867659090909
Hellboy,120.0,"Action,Adventure,Fantasy",5.4,19534,60000000,59623958,99823958,39823958,0.6637326333333333
Annihilation,115.0,"Adventure,Drama,Horror",6.9,228664,55000000,32732301,43070915,-11929085,-0.21689245454545455
Fantastic Beasts and Where to Find Them,132.0,"Adventure,Family,Fantasy",7.3,365353,180000000,234037575,802402853,622402853,3.457793627777778
Pan,111.0,"Adventure,Comedy,Family",5.8,55867,150000000,35088320,151525973,1525973,0.010173153333333334
The Adventures of Tintin,107.0,"Action,Adventure,Animation",7.3,202430,130000000,77591831,373993951,243993951,1.8768765461538461
xXx: Return of Xander Cage,107.0,"Action,Adventure,Thriller",5.2,77976,85000000,44898413,345033359,260033359,3.059215988235294
In the Heart of the Sea,122.0,"Action,Adventure,Biography",6.9,108628,100000000,25020758,89693309,-10306691,-0.10306691
Arthur Christmas,97.0,"Adventure,Animation,Comedy",7.1,45439,85000000,46462469,149717124,64717124,0.7613779294117647
Rise of the Guardians,97.0,"Action,Adventure,Animation",7.3,145281,145000000,103412758,306900902,161900902,1.1165579448275862
Kung Fu Panda 2,90.0,"Action,Adventure,Animation",7.2,228465,150000000,165249063,664837547,514837547,3.4322503133333333
Riddick,119.0,"Action,Adventure,Sci-Fi",6.4,144821,38000000,42025135,94763758,56763758,1.4937831052631578
Deadpool,108.0,"Action,Adventure,Comedy",8.0,820847,58000000,363070709,801025593,743025593,12.810786086206896
Despicable Me 2,98.0,"Adventure,Animation,Comedy",7.4,344230,76000000,368065385,975216835,899216835,11.831800460526315
The Young and Prodigious T.S. Spivet,105.0,"Action,Adventure,Comedy",7.1,15372,33000000,176847,357687,-32642313,-0.989161
Dawn of the Planet of the Apes,130.0,"Action,Adventure,Drama",7.6,390199,170000000,208545589,710644566,540644566,3.1802621529411765
Mechanic: Resurrection,98.0,"Action,Adventure,Thriller",5.7,67275,40000000,21218403,109738840,69738840,1.743471
World War Z,116.0,"Action,Adventure,Horror",7.0,553751,190000000,202359711,531514650,341514650,1.7974455263157896
Godzilla,123.0,"Action,Adventure,Sci-Fi",6.4,350687,160000000,200676069,529076069,369076069,2.30672543125
The Jungle Book,106.0,"Adventure,Drama,Family",7.4,240821,175000000,364001123,962854547,787854547,4.502025982857143
Now You See Me 2,129.0,"Action,Adventure,Comedy",6.5,216219,90000000,65075540,328325007,238325007,2.648055633333333
Transformers: The Last Knight,154.0,"Action,Adventure,Sci-Fi",5.2,119007,217000000,130168683,602893340,385893340,1.7783103225806451
Captain America: Civil War,147.0,"Action,Adventure,Sci-Fi",7.8,583507,250000000,408084349,1140069413,890069413,3.560277652
Madagascar 3: Europe's Most Wanted,93.0,"Adventure,Animation,Comedy",6.8,146858,145000000,216391482,746921271,601921271,4.151181179310345
Inception,148.0,"Action,Adventure,Sci-Fi",8.8,1841066,160000000,292576195,835524642,675524642,4.2220290125
The Hunger Games,142.0,"Action,Adventure,Sci-Fi",7.2,795227,80000000,408010692,677923379,597923379,7.4740422375
Sausage Party,89.0,"Adventure,Animation,Comedy",6.2,159111,19000000,97670358,141344255,122344255,6.439171315789474
Alpha,96.0,"Adventure,Drama,Family",6.7,41882,51000000,35851379,99624873,48624873,0.9534288823529412
Kubo and the Two Strings,101.0,"Action,Adventure,Animation",7.8,105578,55000000,48023088,77548122,22548122,0.40996585454545453
The Book of Life,95.0,"Adventure,Animation,Comedy",7.3,59486,50000000,50151543,97651543,47651543,0.95303086
Ice Age: Collision Course,94.0,"Adventure,Animation,Comedy",5.7,48932,105000000,64063008,402156682,297156682,2.830063638095238
The Hobbit: The Battle of the Five Armies,144.0,"Adventure,Fantasy",7.4,438621,250000000,255119788,945577621,695577621,2.782310484
Avengers: Age of Ultron,141.0,"Action,Adventure,Sci-Fi",7.3,665594,330600000,459005868,1403013963,1072413963,3.2438413883847548
Everest,121.0,"Action,Adventure,Biography",7.1,181133,65000000,43482270,221297061,156297061,2.404570169230769
War for the Planet of the Apes,140.0,"Action,Adventure,Drama",7.5,201943,152000000,146880162,489592267,337592267,2.2210017565789473
Resident Evil: Afterlife,96.0,"Action,Adventure,Horror",5.9,153270,57500000,60128566,295874190,238374190,4.145638086956522
Your Highness,102.0,"Adventure,Comedy,Fantasy",5.5,92940,50000000,21596445,26121638,-23878362,-0.47756724
Teenage Mutant Ninja Turtles,101.0,"Action,Adventure,Comedy",5.8,192220,125000000,191204754,485004754,360004754,2.880038032
Hop,95.0,"Adventure,Animation,Comedy",5.4,28893,63000000,108085305,188657593,125657593,1.9945649682539683
Tarzan,94.0,"Adventure,Animation,Drama",4.8,11728,145000000,171091819,448191819,303191819,2.0909780620689653
Rogue One: A Star Wars Story,133.0,"Action,Adventure,Sci-Fi",7.8,478592,200000000,532177324,1049102856,849102856,4.24551428
Shazam!,132.0,"Action,Adventure,Comedy",7.4,109051,85000000,139606856,362899733,277899733,3.269408623529412
Ant-Man,117.0,"Action,Adventure,Comedy",7.3,501213,130000000,180202163,518858449,388858449,2.9912188384615384
Exodus: Gods and Kings,150.0,"Action,Adventure,Drama",6.0,150858,140000000,65014513,268314513,128314513,0.9165322357142857
The Great Wall,103.0,"Action,Adventure,Fantasy",6.0,111602,150000000,45157105,334486852,184486852,1.2299123466666666
Finding Dory,97.0,"Adventure,Animation,Comedy",7.3,213542,200000000,486295561,1021215193,821215193,4.106075965
The 5th Wave,112.0,"Action,Adventure,Drama",5.2,90788,38000000,34912982,111336398,73336398,1.9299052105263157
Captain America: The First Avenger,124.0,"Action,Adventure,Sci-Fi",6.9,668137,140000000,176654505,370569776,230569776,1.6469269714285715
Yogi Bear,80.0,"Adventure,Animation,Comedy",4.6,18934,80000000,100246011,204774690,124774690,1.559683625
Fantastic Four,100.0,"Action,Adventure,Drama",4.3,140148,120000000,56117548,167849187,47849187,0.398743225
Underdogs,106.0,"Adventure,Animation,Family",6.5,8197,2500000,35017,1392649,-1107351,-0.4429404
Johnny English Reborn,101.0,"Action,Adventure,Comedy",6.3,110824,45000000,8406711,164640401,119640401,2.6586755777777777
Fun Size,86.0,"Adventure,Comedy",5.4,12926,14000000,9409538,11166615,-2833385,-0.20238464285714286
After Earth,100.0,"Action,Adventure,Drama",4.8,181687,130000000,60522097,251499665,121499665,0.9346128076923077
Avengers: Infinity War,149.0,"Action,Adventure,Sci-Fi",8.5,670926,300000000,678815482,2048134200,1748134200,5.827114
Christopher Robin,104.0,"Adventure,Animation,Comedy",7.3,52737,75000000,99215042,197504758,122504758,1.6333967733333334
The Star,86.0,"Adventure,Animation,Comedy",6.1,5159,20000000,40847995,62758010,42758010,2.1379005
The Last Airbender,103.0,"Action,Adventure,Family",4.1,137734,150000000,131772187,319713881,169713881,1.1314258733333333
The Chronicles of Narnia: The Voyage of the Dawn Treader,113.0,"Adventure,Family,Fantasy",6.3,129663,155000000,104386950,418186950,263186950,1.6979803225806451
Cloudy with a Chance of Meatballs 2,95.0,"Adventure,Animation,Comedy",6.4,81010,78000000,119793567,274392649,196392649,2.517854474358974
Beasts of the Southern Wild,93.0,"Adventure,Drama,Fantasy",7.3,77440,1800000,12795746,23265132,21465132,11.925073333333334
The Expendables 3,126.0,"Action,Adventure,Thriller",6.1,156432,100000000,39322544,209461378,109461378,1.09461378
Snatched,90.0,"Action,Adventure,Comedy",4.5,29997,42000000,45852178,57852177,15852177,0.37743278571428573
How to Train Your Dragon: The Hidden World,104.0,"Action,Adventure,Animation",7.6,60769,129000000,160791800,519258283,390258283,3.025258007751938
