movie,runtime_minutes,genres,averagerating,numvotes,production_budget,domestic_gross,worldwide_gross,net_revenue,ROI%
The Croods,98.0,"Action,Adventure,Animation",7.2,176699,135000000,187168425,573068425,438068425,3.2449512962962963
Legend of the Guardians: The Owls of Ga'Hoole,97.0,"Action,Adventure,Animation",7.0,73790,100000000,55675313,139716717,39716717,0.39716717
Despicable Me,95.0,"Animation,Comedy,Family",7.7,464511,69000000,251513985,543464573,474464573,6.87629815942029
Norm of the North,90.0,"Adventure,Animation,Comedy",3.6,7951,18000000,17062499,30535660,12535660,0.6964255555555555
Trolls,92.0,"Adventure,Animation,Comedy",6.5,63295,125000000,153707064,344150134,219150134,1.753201072
The Lego Movie,100.0,"Action,Adventure,Animation",7.8,304179,60000000,257784718,457729388,397729388,6.628823133333333
Mars Needs Moms,88.0,"Adventure,Animation,Family",5.4,19823,150000000,21392758,39549758,-110450242,-0.7363349466666667
Cars 3,102.0,"Adventure,Animation,Comedy",6.8,59408,175000000,152901115,383541369,208541369,1.1916649657142857
Brave,93.0,"Adventure,Animation,Comedy",7.1,338728,185000000,237282182,554606532,369606532,1.997873145945946
Alvin and the Chipmunks: Chipwrecked,87.0,"Adventure,Animation,Comedy",4.4,28158,80000000,133107389,349088523,269088523,3.3636065375
Happy Feet Two,100.0,"Adventure,Animation,Comedy",5.9,38396,135000000,64006466,157956466,22956466,0.1700478962962963
The Boss Baby,97.0,"Adventure,Animation,Comedy",6.3,93730,125000000,175003033,510878762,385878762,3.087030096
Tangled,100.0,"Adventure,Animation,Comedy",7.8,366366,260000000,200821936,586477240,326477240,1.2556816923076923
The Smurfs,103.0,"Adventure,Animation,Comedy",5.5,77577,110000000,142614158,563749323,453749323,4.124993845454545
Shrek Forever After,93.0,"Adventure,Animation,Comedy",6.3,167532,165000000,238736787,756244673,591244673,3.5833010484848486
How to Train Your Dragon,98.0,"Action,Adventure,Animation",8.1,611299,165000000,217581232,494870992,329870992,1.9992181333333334
Ferdinand,108.0,"Adventure,Animation,Comedy",6.7,40229,111000000,84410380,289847930,178847930,1.6112426126126127
Puss in Boots,90.0,"Action,Adventure,Animation",6.6,133355,130000000,149260504,554987477,424987477,3.2691344384615384
The Emoji Movie,86.0,"Adventure,Animation,Comedy",3.2,47294,50000000,86089513,216562312,166562312,3.33124624
Epic,102.0,"Adventure,Animation,Family",6.7,95318,100000000,107518682,262794441,162794441,1.62794441
Frankenweenie,87.0,"Animation,Comedy,Family",7.0,89489,39000000,35287788,81150788,42150788,1.080789435897436
Frozen,102.0,"Adventure,Animation,Comedy",7.5,516998,150000000,400738009,1272469910,1122469910,7.483132733333333
The Pirates! Band of Misfits,88.0,"Adventure,Animation,Comedy",6.7,41958,55000000,31051126,136143605,81143605,1.4753382727272728
Ice Age: Continental Drift,88.0,"Adventure,Animation,Comedy",6.6,175601,95000000,161321843,879765137,784765137,8.26068565263158
Smallfoot,96.0,"Adventure,Animation,Comedy",6.7,23295,80000000,83240103,213691277,133691277,1.6711409625
Winnie the Pooh,63.0,"Adventure,Animation,Comedy",7.2,19605,30000000,26692846,50145607,20145607,0.6715202333333333
Kung Fu Panda 3,95.0,"Action,Adventure,Animation",7.1,116166,140000000,143528619,517599142,377599142,2.6971367285714285
The SpongeBob Movie: Sponge Out of Water,92.0,"Adventure,Animation,Comedy",6.0,43560,74000000,162994032,311013181,237013181,3.2028808243243243
Sherlock Gnomes,86.0,"Adventure,Animation,Comedy",5.1,8030,59000000,43242871,87527651,28527651,0.48351950847457625
Monsters University,104.0,"Adventure,Animation,Comedy",7.3,291887,200000000,268488329,743588329,543588329,2.717941645
The Good Dinosaur,93.0,"Adventure,Animation,Comedy",6.7,91465,187500000,123087120,333771037,146271037,0.7801121973333334
Inside Out,95.0,"Adventure,Animation,Comedy",8.2,536181,175000000,356461711,854235992,679235992,3.881348525714286
Megamind,95.0,"Action,Animation,Comedy",7.3,207488,130000000,148415853,321887208,191887208,1.4760554461538462
Wreck-It Ralph,101.0,"Adventure,Animation,Comedy",7.7,344496,165000000,189412677,496511521,331511521,2.0091607333333332
Early Man,89.0,"Adventure,Animation,Comedy",6.1,15882,50000000,8267544,45285890,-4714110,-0.0942822
Big Hero 6,102.0,"Action,Adventure,Animation",7.8,371204,165000000,222527828,652127828,487127828,2.952289866666667
Zootopia,108.0,"Adventure,Animation,Comedy",8.0,383446,150000000,341268248,1019429616,869429616,5.79619744
Despicable Me 3,89.0,"Adventure,Animation,Comedy",6.3,92580,75000000,264624300,1034727750,959727750,12.79637
Hotel Transylvania 3: Summer Vacation,97.0,"Adventure,Animation,Comedy",6.3,42299,65000000,167500092,527079962,462079962,7.108922492307692
Zambezia,83.0,"Adventure,Animation,Comedy",5.8,6010,20000000,0,34454336,14454336,0.7227168
Peter Rabbit,95.0,"Adventure,Animation,Comedy",6.6,27908,50000000,115234093,347136477,297136477,5.94272954
Storks,87.0,"Adventure,Animation,Comedy",6.8,50448,70000000,72679278,183353431,113353431,1.6193347285714286
The Illusionist,80.0,"Animation,Drama",7.5,31734,16500000,39868642,83792062,67292062,4.0783067878787875
The Nut Job,85.0,"Adventure,Animation,Comedy",5.7,24587,30000000,64251538,122529966,92529966,3.0843322
The Angry Birds Movie,97.0,"Action,Animation,Comedy",6.3,69624,73000000,107509366,352327887,279327887,3.826409410958904
Coco,105.0,"Adventure,Animation,Comedy",8.4,277194,175000000,209726015,798008101,623008101,3.5600462914285713
The Peanuts Movie,88.0,"Adventure,Animation,Comedy",7.1,39149,99000000,130178411,250091610,151091610,1.5261778787878788
Cars 2,106.0,"Adventure,Animation,Comedy",6.2,138914,200000000,191450875,560155383,360155383,1.800776915
Free Birds,91.0,"Adventure,Animation,Comedy",5.9,20934,55000000,55750480,110387072,55387072,1.0070376727272727
Captain Underpants: The First Epic Movie,89.0,"Action,Animation,Comedy",6.2,21903,38000000,73921000,126577874,88577874,2.3309966842105263
Thunder and the House of Magic,85.0,"Adventure,Animation,Comedy",6.3,5626,34000000,4091,62582520,28582520,0.8406623529411764
Bilal: A New Breed of Hero,105.0,"Action,Adventure,Animation",8.0,16854,30000000,490973,648599,-29351401,-0.9783800333333333
Rio 2,101.0,"Adventure,Animation,Comedy",6.3,72209,130000000,131538435,492846291,362846291,2.7911253153846154
Alvin and the Chipmunks: The Road Chip,92.0,"Adventure,Animation,Comedy",5.1,14507,90000000,85886987,249517956,159517956,1.7724217333333334
Moana,107.0,"Adventure,Animation,Comedy",7.6,224253,150000000,248757044,637517365,487517365,3.2501157666666667
The Smurfs 2,105.0,"Adventure,Animation,Comedy",5.4,34229,110000000,71017784,348547523,238547523,2.1686138454545456
Minions,91.0,"Adventure,Animation,Comedy",6.4,193917,74000000,336045770,1160336173,1086336173,14.680218554054054
A Monster Calls,108.0,"Animation,Drama,Fantasy",7.5,70416,43000000,3740823,46414530,3414530,0.07940767441860465
The Lego Ninjago Movie,101.0,"Action,Adventure,Animation",6.0,18926,70000000,59281555,122737201,52737201,0.7533885857142857
Dragon Ball Super: Broly,100.0,"Action,Adventure,Animation",8.0,16465,8500000,30376755,122747755,114247755,13.440912352941176
Home,94.0,"Adventure,Animation,Comedy",6.6,85831,130000000,177397510,385997896,255997896,1.9692145846153846
Sing,108.0,"Animation,Comedy,Family",7.1,115951,75000000,270329045,634454789,559454789,7.459397186666667
The Boxtrolls,96.0,"Adventure,Animation,Comedy",6.8,50763,60000000,50837305,111946251,51946251,0.86577085
Mr. Peabody & Sherman,92.0,"Adventure,Animation,Comedy",6.8,57277,145000000,111506430,269806430,124806430,0.860734
Rango,107.0,"Adventure,Animation,Comedy",7.2,215761,135000000,123477607,245724600,110724600,0.8201822222222223
The Little Prince,108.0,"Adventure,Animation,Drama",7.7,50015,77500000,1311213,102028919,24528919,0.3165021806451613
Incredibles 2,118.0,"Action,Adventure,Animation",7.7,203510,200000000,608581744,1242520711,1042520711,5.212603555
Toy Story 3,103.0,"Adventure,Animation,Comedy",8.3,682218,200000000,415004880,1068879522,868879522,4.34439761
The Secret Life of Pets,87.0,"Adventure,Animation,Comedy",6.5,161997,75000000,368384330,886750534,811750534,10.823340453333333
Rio,96.0,"Adventure,Animation,Comedy",6.9,191621,90000000,143619809,487519809,397519809,4.416886766666667
Turbo,96.0,"Adventure,Animation,Comedy",6.4,74639,135000000,83028130,286896578,151896578,1.125159837037037
Smurfs: The Lost Village,90.0,"Adventure,Animation,Comedy",6.0,15612,60000000,45020282,197578586,137578586,2.292976433333333
Hotel Transylvania 2,89.0,"Animation,Comedy,Family",6.7,92905,80000000,169700110,469500298,389500298,4.868753725
ParaNorman,92.0,"Adventure,Animation,Comedy",7.0,87250,60000000,56003051,108119662,48119662,0.8019943666666667
How to Train Your Dragon 2,102.0,"Action,Adventure,Animation",7.8,278205,145000000,177002924,614586270,469586270,3.238526
The Lego Batman Movie,104.0,"Action,Animation,Comedy",7.3,116433,80000000,175750384,310660018,230660018,2.883250225
Foodfight!,91.0,"Action,Animation,Comedy",1.9,8248,45000000,0,73706,-44926294,-0.9983620888888889
Penguins of Madagascar,92.0,"Adventure,Animation,Comedy",6.7,72551,132000000,83350911,366942531,234942531,1.779867659090909
The Adventures of Tintin,107.0,"Action,Adventure,Animation",7.3,202430,130000000,77591831,373993951,243993951,1.8768765461538461
Arthur Christmas,97.0,"Adventure,Animation,Comedy",7.1,45439,85000000,46462469,149717124,64717124,0.7613779294117647
Rise of the Guardians,97.0,"Action,Adventure,Animation",7.3,145281,145000000,103412758,306900902,161900902,1.1165579448275862
Kung Fu Panda 2,90.0,"Action,Adventure,Animation",7.2,228465,150000000,165249063,664837547,514837547,3.4322503133333333
Despicable Me 2,98.0,"Adventure,Animation,Comedy",7.4,344230,76000000,368065385,975216835,899216835,11.831800460526315
Madagascar 3: Europe's Most Wanted,93.0,"Adventure,Animation,Comedy",6.8,146858,145000000,216391482,746921271,601921271,4.151181179310345
Sausage Party,89.0,"Adventure,Animation,Comedy",6.2,159111,19000000,97670358,141344255,122344255,6.439171315789474
Kubo and the Two Strings,101.0,"Action,Adventure,Animation",7.8,105578,55000000,48023088,77548122,22548122,0.40996585454545453
The Book of Life,95.0,"Adventure,Animation,Comedy",7.3,59486,50000000,50151543,97651543,47651543,0.95303086
Ice Age: Collision Course,94.0,"Adventure,Animation,Comedy",5.7,48932,105000000,64063008,402156682,297156682,2.830063638095238
Anomalisa,90.0,"Animation,Comedy,Drama",7.3,58010,8000000,3759286,5706168,-2293832,-0.286729
Hop,95.0,"Adventure,Animation,Comedy",5.4,28893,63000000,108085305,188657593,125657593,1.9945649682539683
Tarzan,94.0,"Adventure,Animation,Drama",4.8,11728,145000000,171091819,448191819,303191819,2.0909780620689653
Finding Dory,97.0,"Adventure,Animation,Comedy",7.3,213542,200000000,486295561,1021215193,821215193,4.106075965
Yogi Bear,80.0,"Adventure,Animation,Comedy",4.6,18934,80000000,100246011,204774690,124774690,1.559683625
Underdogs,106.0,"Adventure,Animation,Family",6.5,8197,2500000,35017,1392649,-1107351,-0.4429404
Christopher Robin,104.0,"Adventure,Animation,Comedy",7.3,52737,75000000,99215042,197504758,122504758,1.6333967733333334
The Star,86.0,"Adventure,Animation,Comedy",6.1,5159,20000000,40847995,62758010,42758010,2.1379005
Hotel Transylvania,91.0,"Animation,Comedy,Family",7.1,204571,85000000,148313048,378505812,293505812,3.4530095529411766
Cloudy with a Chance of Meatballs 2,95.0,"Adventure,Animation,Comedy",6.4,81010,78000000,119793567,274392649,196392649,2.517854474358974
How to Train Your Dragon: The Hidden World,104.0,"Action,Adventure,Animation",7.6,60769,129000000,160791800,519258283,390258283,3.025258007751938
