movie,runtime_minutes,genres,averagerating,numvotes,production_budget,domestic_gross,worldwide_gross,net_revenue,ROI%
Moneyball,133.0,"Biography,Drama,Sport",7.6,326657,50000000,75605492,111300835,61300835,1.2260167
Captain Phillips,134.0,"Biography,Drama,Thriller",7.8,387402,55000000,107136417,220648184,165648184,3.0117851636363637
Chasing Mavericks,116.0,"Biography,Drama,Sport",7.2,28994,20000000,6002756,8300821,-11699179,-0.58495895
My Week with Marilyn,99.0,"Biography,Drama",7.0,79337,10000000,14597405,34240572,24240572,2.4240572
The Revenant,156.0,"Action,Adventure,Biography",8.0,621193,135000000,183637894,532938302,397938302,2.947691125925926
Lincoln,150.0,"Biography,Drama,History",7.4,228701,65000000,182207973,273346281,208346281,3.2053274
Danny Collins,106.0,"Biography,Comedy,Drama",7.0,27435,10000000,5637066,8465845,-1534155,-0.1534155
Winchester,99.0,"Biography,Drama,Fantasy",5.4,24351,3500000,25091816,44378040,40878040,11.67944
The Runaways,106.0,"Biography,Drama,Music",6.6,43792,9500000,3573673,5278632,-4221368,-0.4443545263157895
Grace of Monaco,103.0,"Biography,Drama,Romance",5.7,16685,30000000,0,25199891,-4800109,-0.16000363333333334
Admiral,151.0,"Action,Adventure,Biography",7.0,7978,20000000,0,38585047,18585047,0.92925235
Only the Brave,134.0,"Action,Biography,Drama",7.7,45482,38000000,18340051,24555177,-13444823,-0.3538111315789474
42,128.0,"Biography,Drama,Sport",7.5,77703,31000000,95020213,97470701,66470701,2.1442161612903226
The Devil's Double,109.0,"Biography,Drama,Thriller",7.1,58342,19100000,1361512,5965646,-13134354,-0.6876625130890053
Unbroken,137.0,"Biography,Drama,Sport",7.2,129981,65000000,115637895,163527824,98527824,1.5158126769230769
A Walk in the Woods,104.0,"Adventure,Biography,Comedy",6.3,22033,8000000,29499394,37119358,29119358,3.63991975
Soul Surfer,112.0,"Biography,Drama,Family",7.1,41659,18000000,43853424,47158652,29158652,1.619925111111111
The Fighter,116.0,"Biography,Drama,Sport",7.8,316539,11000000,93617009,129262388,118262388,10.751126181818181
The Sessions,95.0,"Biography,Comedy,Drama",7.2,39731,1000000,6002451,11495204,10495204,10.495204
American Sniper,133.0,"Action,Biography,Drama",7.3,401915,58000000,350126372,547326372,489326372,8.436661586206897
Jobs,128.0,"Biography,Drama",5.9,88788,18000000,16131410,43402515,25402515,1.4112508333333333
Birth of the Dragon,95.0,"Action,Biography,Drama",5.4,6090,31000000,6901965,7220490,-23779510,-0.7670809677419355
Darkest Hour,125.0,"Biography,Drama,History",7.4,136546,30000000,56443120,150807172,120807172,4.026905733333333
Green Book,130.0,"Biography,Comedy,Drama",8.3,204972,23000000,85080171,322034439,299034439,13.001497347826087
Can You Ever Forgive Me?,106.0,"Biography,Comedy,Crime",7.2,29473,10000000,8803865,11752387,1752387,0.1752387
The 15:17 to Paris,94.0,"Biography,Drama,Thriller",5.2,21880,30000000,36276286,56096200,26096200,0.8698733333333334
127 Hours,94.0,"Adventure,Biography,Drama",7.6,323949,18000000,18335230,60217171,42217171,2.345398388888889
The Founder,115.0,"Biography,Drama,History",7.2,97841,15000000,12786053,24403192,9403192,0.6268794666666667
The Railway Man,116.0,"Biography,Drama,Romance",7.1,34586,18000000,4438438,23910210,5910210,0.328345
Rocketman,121.0,"Biography,Drama,Music",7.7,24266,41000000,57342725,108642725,67642725,1.6498225609756099
Legend,132.0,"Biography,Crime,Drama",7.0,138947,25000000,15502112,23506237,-1493763,-0.05975052
My All-American,118.0,"Biography,Drama,Sport",7.2,5058,20000000,2246000,2246000,-17754000,-0.8877
Lion,118.0,"Biography,Drama",8.1,181601,12000000,51739495,149570720,137570720,11.464226666666667
Rush,123.0,"Action,Biography,Drama",8.1,393437,38000000,26947624,98230839,60230839,1.5850220789473684
Wild,115.0,"Adventure,Biography,Drama",7.1,110138,15000000,37880356,52460543,37460543,2.4973695333333334
Eddie the Eagle,106.0,"Biography,Comedy,Drama",7.4,75331,23000000,15789389,45060480,22060480,0.9591513043478261
Free State of Jones,139.0,"Action,Biography,Drama",6.9,45135,50000000,20810036,23237252,-26762748,-0.53525496
First Man,141.0,"Biography,Drama,History",7.4,120009,60000000,44936545,105203825,45203825,0.7533970833333333
Jackie,100.0,"Biography,Drama,History",6.7,66008,9000000,13960394,36588512,27588512,3.0653902222222222
The Lost City of Z,141.0,"Adventure,Biography,Drama",6.6,66475,30000000,8574339,17121823,-12878177,-0.4292725666666667
Straight Outta Compton,147.0,"Biography,Drama,History",7.9,165307,28000000,161197785,202182981,174182981,6.22082075
The Iceman,106.0,"Biography,Crime,Drama",6.9,65571,10000000,1930282,3623609,-6376391,-0.6376391
The Lady in the Van,104.0,"Biography,Comedy,Drama",6.7,23105,6000000,10021175,42320503,36320503,6.053417166666667
The Post,116.0,"Biography,Drama,History",7.2,108017,50000000,81903458,179748880,129748880,2.5949776
Fruitvale Station,85.0,"Biography,Drama,Romance",7.5,68187,900000,16098998,17549645,16649645,18.499605555555554
Life,111.0,"Biography,Drama",6.1,6604,75000000,64062587,73521587,-1478413,-0.019712173333333333
Sully,96.0,"Biography,Drama",7.5,202718,60000000,125070033,238524556,178524556,2.9754092666666665
Casino Jack,108.0,"Biography,Comedy,Crime",6.2,16191,12500000,2039869,2272186,-10227814,-0.81822512
Made in Dagenham,113.0,"Biography,Comedy,Drama",7.2,13121,8000000,1095369,15644196,7644196,0.9555245
J. Edgar,137.0,"Biography,Crime,Drama",6.6,115925,35000000,37306030,84606030,49606030,1.4173151428571429
Queen of the Desert,128.0,"Adventure,Biography,Drama",5.7,8529,36000000,0,1578543,-34421457,-0.9561515833333334
12 Years a Slave,134.0,"Biography,Drama,History",8.1,577301,20000000,56671993,181025343,161025343,8.05126715
Churchill,105.0,"Biography,Drama,History",6.3,12047,10000000,1279681,7582196,-2417804,-0.2417804
Philomena,98.0,"Biography,Comedy,Drama",7.6,88704,12000000,37709979,98963392,86963392,7.246949333333333
The Iron Lady,105.0,"Biography,Drama",6.4,96066,14000000,29959436,115592104,101592104,7.256578857142857
Snowden,134.0,"Biography,Drama,Thriller",7.3,119149,50000000,21587519,35380918,-14619082,-0.29238164
Adrift,96.0,"Action,Adventure,Biography",6.6,34115,35000000,31445011,57897191,22897191,0.6542054571428572
The Greatest Showman,105.0,"Biography,Drama,Musical",7.6,199663,84000000,174340174,386665550,302665550,3.6031613095238093
Rosewater,103.0,"Biography,Drama",6.6,9836,10000000,3128941,3185717,-6814283,-0.6814283
Whiskey Tango Foxtrot,112.0,"Biography,Comedy,Drama",6.6,46265,35000000,23083334,25350747,-9649253,-0.27569294285714285
"Paul, Apostle of Christ",108.0,"Adventure,Biography,Drama",6.7,5662,5000000,17547999,25529498,20529498,4.1058996
Big Eyes,106.0,"Biography,Crime,Drama",7.0,77447,10000000,14482031,27317872,17317872,1.7317872
Black Mass,123.0,"Biography,Crime,Drama",6.9,155847,53000000,62575678,98837872,45837872,0.8648655094339622
Chocolat,119.0,"Biography,Drama",7.0,5772,25000000,71309760,152500343,127500343,5.10001372
I Can Only Imagine,110.0,"Biography,Drama,Family",7.4,11439,7000000,83482352,85604221,78604221,11.22917442857143
Vice,132.0,"Biography,Comedy,Drama",7.2,72855,60000000,47836282,70883171,10883171,0.18138618333333334
The Man Who Knew Infinity,108.0,"Biography,Drama",7.2,43575,10000000,3877922,12382122,2382122,0.2382122
Get on Up,139.0,"Biography,Drama,Music",6.9,19024,30000000,30569935,33339868,3339868,0.11132893333333334
The Walk,123.0,"Adventure,Biography,Drama",7.3,109714,35000000,10161183,61492104,26492104,0.7569172571428572
American Made,115.0,"Action,Biography,Comedy",7.2,131043,50000000,51342000,135569212,85569212,1.71138424
A Street Cat Named Bob,103.0,"Biography,Comedy,Drama",7.4,23204,8000000,82703,17382693,9382693,1.172836625
Kill the Messenger,112.0,"Biography,Crime,Drama",7.0,41231,5000000,2450846,6656705,1656705,0.331341
The Infiltrator,127.0,"Biography,Crime,Drama",7.0,61547,47500000,15436808,20718104,-26781896,-0.5638293894736842
Selma,128.0,"Biography,Drama,History",7.5,77633,20000000,52076908,66776576,46776576,2.3388288
Steve Jobs,122.0,"Biography,Drama",7.2,138668,30000000,17766658,35579007,5579007,0.1859669
Welcome to Marwen,116.0,"Biography,Comedy,Drama",6.1,8920,45000000,10763520,12874922,-32125078,-0.7138906222222222
Secretariat,123.0,"Biography,Drama,Family",7.2,24536,35000000,59699513,60376247,25376247,0.7250356285714286
Lone Survivor,121.0,"Action,Biography,Drama",7.5,246641,40000000,125095601,149804632,109804632,2.7451158
Woman in Gold,109.0,"Biography,Drama,History",7.3,48501,11000000,33307793,58586407,47586407,4.326037
Beautiful Boy,120.0,"Biography,Drama",7.3,30368,25000000,7634767,13031424,-11968576,-0.47874304
Mr. Turner,150.0,"Biography,Drama,History",6.8,22661,14000000,3958546,25187026,11187026,0.7990732857142857
BlacKkKlansman,135.0,"Biography,Crime,Drama",7.5,149005,15000000,49275340,93017335,78017335,5.201155666666667
The Wolf of Wall Street,180.0,"Biography,Crime,Drama",8.2,1035358,100000000,116900694,389870414,289870414,2.89870414
Compliance,90.0,"Biography,Crime,Drama",6.4,28703,270000,319285,830700,560700,2.0766666666666667
The Sapphires,103.0,"Biography,Comedy,Drama",7.0,12143,9000000,2450867,20395040,11395040,1.2661155555555557
The 33,127.0,"Biography,Drama,History",6.9,32263,25000000,12227722,28400715,3400715,0.1360286
Saving Mr. Banks,125.0,"Biography,Comedy,Drama",7.5,140678,35000000,83299761,114962525,79962525,2.2846435714285716
The Imitation Game,114.0,"Biography,Drama,Thriller",8.0,620834,15000000,91125143,227740463,212740463,14.182697533333334
Concussion,123.0,"Biography,Drama,Sport",7.1,77576,35000000,34531832,50363790,15363790,0.43896542857142856
Dangal,161.0,"Action,Biography,Drama",8.5,123638,9500000,12391761,294654618,285154618,30.01627557894737
Argo,120.0,"Biography,Drama,Thriller",7.7,534683,44500000,136025503,227140757,182640757,4.104286674157303
Loving,123.0,"Biography,Drama,Romance",7.0,28079,9000000,7710234,12898064,3898064,0.43311822222222224
Marshall,118.0,"Biography,Crime,Drama",7.2,14419,12000000,10051659,10116816,-1883184,-0.156932
"McFarland, USA",129.0,"Biography,Drama,Sport",7.4,31735,17000000,44480275,45707924,28707924,1.688701411764706
Mandela: Long Walk to Freedom,141.0,"Biography,Drama,History",7.1,25027,35000000,8323085,29890402,-5109598,-0.1459885142857143
Florence Foster Jenkins,111.0,"Biography,Comedy,Drama",6.8,44970,29000000,27383770,56000339,27000339,0.9310461724137931
Hidden Figures,127.0,"Biography,Drama,History",7.8,171131,25000000,169607287,231771716,206771716,8.27086864
The Social Network,120.0,"Biography,Drama",7.7,568578,40000000,96962694,224922135,184922135,4.623053375
Lee Daniels' The Butler,132.0,"Biography,Drama",7.2,102468,30000000,116632095,177025498,147025498,4.900849933333333
The Birth of a Nation,120.0,"Biography,Drama,History",6.4,18442,10000000,15861566,16891011,6891011,0.6891011
Queen of Katwe,124.0,"Biography,Drama,Sport",7.4,13039,15000000,8874389,10055481,-4944519,-0.3296346
Conviction,107.0,"Biography,Crime,Drama",7.2,39771,12500000,6797696,11826980,-673020,-0.0538416
Big Miracle,107.0,"Biography,Drama,Family",6.5,17585,40000000,20157300,25268680,-14731320,-0.368283
Bleed for This,117.0,"Biography,Drama,Sport",6.8,21946,16000000,5083906,6603926,-9396074,-0.587254625
Jersey Boys,134.0,"Biography,Drama,Music",6.8,30410,40000000,47047013,65282732,25282732,0.6320683
Gotti,112.0,"Biography,Crime,Drama",4.8,10358,10000000,4286367,6089100,-3910900,-0.39109
On the Basis of Sex,120.0,"Biography,Drama",6.9,12083,20000000,24622687,38073377,18073377,0.90366885
The Favourite,119.0,"Biography,Drama,History",7.6,116011,15000000,34366783,94113929,79113929,5.274261933333333
Freeheld,103.0,"Biography,Drama,Romance",6.5,10534,7000000,546201,1732228,-5267772,-0.7525388571428572
Suffragette,106.0,"Biography,Drama,History",6.9,34306,14000000,4702420,34044909,20044909,1.4317792142857142
Fair Game,108.0,"Biography,Drama,Thriller",6.8,43862,50000000,11497497,26097497,-23902503,-0.47805006
In the Heart of the Sea,122.0,"Action,Adventure,Biography",6.9,108628,100000000,25020758,89693309,-10306691,-0.10306691
Hands of Stone,111.0,"Action,Biography,Drama",6.6,12851,20000000,4712792,5031975,-14968025,-0.74840125
A Dangerous Method,99.0,"Biography,Drama,Romance",6.4,93259,20000000,5702083,14807531,-5192469,-0.25962345
The Big Short,130.0,"Biography,Comedy,Drama",7.8,309227,28000000,70259870,133162752,105162752,3.7558125714285713
The Fifth Estate,128.0,"Biography,Drama,Thriller",6.2,36392,26000000,3254172,6154172,-19845828,-0.7633010769230769
Mary Queen of Scots,124.0,"Biography,Drama,History",6.3,23866,25000000,16468499,46734733,21734733,0.86938932
Thank You for Your Service,109.0,"Biography,Drama,War",6.5,10006,20000000,9479390,9985316,-10014684,-0.5007342
Race,134.0,"Biography,Drama,Sport",7.1,30777,5000000,19115191,23745772,18745772,3.7491544
Unplanned,106.0,"Biography,Drama",6.3,5945,6000000,18107621,18107621,12107621,2.017936833333333
The Theory of Everything,123.0,"Biography,Drama,Romance",7.7,361534,15000000,35893537,123327692,108327692,7.221846133333333
The Disaster Artist,104.0,"Biography,Comedy,Drama",7.4,111737,10000000,21120616,28717667,18717667,1.8717667
Dallas Buyers Club,117.0,"Biography,Drama",8.0,402462,5000000,27298285,60611845,55611845,11.122369
Machine Gun Preacher,129.0,"Action,Biography,Crime",6.8,60074,30000000,538690,3721988,-26278012,-0.8759337333333334
Million Dollar Arm,124.0,"Biography,Drama,Sport",7.0,41008,25000000,36447959,39217912,14217912,0.56871648
All Eyez on Me,139.0,"Biography,Drama,Music",5.8,18541,45000000,44922302,54876855,9876855,0.21948566666666666
"I, Tonya",120.0,"Biography,Comedy,Drama",7.5,141668,11000000,30014534,53797409,42797409,3.8906735454545456
Hacksaw Ridge,139.0,"Biography,Drama,History",8.1,366904,40000000,67209615,168904682,128904682,3.22261705
Red Dog,92.0,"Biography,Comedy,Drama",7.4,15357,9100000,0,20927794,11827794,1.2997575824175824
Everest,121.0,"Action,Adventure,Biography",7.1,181133,65000000,43482270,221297061,156297061,2.404570169230769
Son of God,138.0,"Biography,Drama,History",5.8,17606,22000000,59700064,70949793,48949793,2.224990590909091
Genius,104.0,"Biography,Drama",6.6,15611,17000000,1361045,7265283,-9734717,-0.5726304117647059
Bernie,99.0,"Biography,Comedy,Crime",6.8,53765,6000000,9204489,10106975,4106975,0.6844958333333333
Bohemian Rhapsody,134.0,"Biography,Drama,Music",8.0,345466,55000000,216303339,894985342,839985342,15.272460763636364
Miracles from Heaven,109.0,"Biography,Drama,Family",7.1,17734,13000000,61705123,73798736,60798736,4.6768258461538466
The Professor and the Madman,124.0,"Biography,Drama,Mystery",7.4,10383,25000000,0,5227233,-19772767,-0.79091068
Kill the Irishman,106.0,"Biography,Crime,Drama",7.1,41504,12000000,1188194,1188194,-10811806,-0.9009838333333333
Stronger,119.0,"Biography,Drama",7.0,33464,30000000,4211129,8786752,-21213248,-0.7071082666666667
Testament of Youth,129.0,"Biography,Drama,History",7.3,23632,10000000,1822250,6646669,-3353331,-0.3353331
Battle of the Sexes,121.0,"Biography,Comedy,Drama",6.7,43245,25000000,12638526,18445379,-6554621,-0.26218484
Denial,109.0,"Biography,Drama",6.7,16593,10000000,4073448,9263940,-736060,-0.073606
