movie,runtime_minutes,genres,averagerating,numvotes,production_budget,domestic_gross,worldwide_gross,net_revenue,ROI%
21 Jump Street,109.0,"Action,Comedy,Crime",7.2,477771,42000000,138447667,202812429,160812429,3.8288673571428573
Small Apartments,96.0,"Comedy,Crime,Drama",6.1,6688,2000000,0,0,-2000000,-1.0
Horrible Bosses,98.0,"Comedy,Crime",6.9,398695,35000000,117538559,212417601,177417601,5.069074314285714
Polisse,127.0,"Crime,Drama",7.3,12506,8900000,176988,22744132,13844132,1.5555204494382022
Machete,105.0,"Action,Crime,Thriller",6.6,182320,12500000,26593646,46370970,33870970,2.7096776
Nine Dead,98.0,"Crime,Drama,Horror",5.5,11358,2000000,0,0,-2000000,-1.0
Shanghai,105.0,"Crime,Drama,Mystery",6.4,8662,50000000,46425,15505922,-34494078,-0.68988156
Shanghai,120.0,"Crime,Mystery,Thriller",7.2,9047,50000000,46425,15505922,-34494078,-0.68988156
Central Intelligence,107.0,"Action,Comedy,Crime",6.3,138872,50000000,127440871,217194805,167194805,3.3438961
The Raven,110.0,"Crime,Mystery,Thriller",6.4,79578,26000000,16008272,30601801,4601801,0.17699234615384615
Sherlock Holmes: A Game of Shadows,129.0,"Action,Adventure,Crime",7.5,394189,125000000,186848418,535663443,410663443,3.285307544
A Nightmare on Elm Street,95.0,"Crime,Drama,Horror",5.2,85497,35000000,63075011,117729621,82729621,2.363703457142857
Escape Plan,115.0,"Action,Crime,Mystery",6.7,211587,70000000,25135965,103735965,33735965,0.48194235714285716
Wild Target,98.0,"Action,Comedy,Crime",6.8,33915,8000000,109338,5314194,-2685806,-0.33572575
Some Guy Who Kills People,97.0,"Comedy,Crime,Drama",6.3,5111,300000,0,0,-300000,-1.0
A Walk Among the Tombstones,114.0,"Action,Crime,Drama",6.5,105116,28000000,26017685,62108587,34108587,1.2181638214285715
Jack Reacher,130.0,"Action,Crime,Thriller",7.0,284547,60000000,80070736,217370736,157370736,2.6228456
Hell or High Water,102.0,"Action,Crime,Drama",7.6,176469,12000000,27007844,37584304,25584304,2.1320253333333334
Captive,97.0,"Action,Crime,Drama",5.4,6017,2000000,2583301,2791973,791973,0.3959865
The Equalizer 2,121.0,"Action,Crime,Thriller",6.7,97963,77000000,102084362,190453132,113453132,1.4734172987012988
Out of the Furnace,116.0,"Crime,Drama,Thriller",6.8,99037,22000000,11330849,15434375,-6565625,-0.2984375
A Lonely Place to Die,99.0,"Adventure,Crime,Thriller",6.3,25547,4000000,0,442550,-3557450,-0.8893625
Kill List,95.0,"Crime,Drama,Horror",6.4,32807,800000,29063,462206,-337794,-0.4222425
The Green Hornet,119.0,"Action,Comedy,Crime",5.8,148622,110000000,98780042,229155503,119155503,1.0832318454545455
War Dogs,114.0,"Comedy,Crime,Drama",7.1,154029,50000000,43034523,86234503,36234503,0.72469006
Inside Job,109.0,"Crime,Documentary",8.3,65304,2000000,4311834,7799257,5799257,2.8996285
Kick-Ass 2,103.0,"Action,Comedy,Crime",6.6,238832,28000000,28795985,63129909,35129909,1.2546396071428572
Broken City,109.0,"Crime,Drama,Thriller",6.2,71704,35000000,19701164,34480045,-519955,-0.014855857142857143
Bullet to the Head,92.0,"Action,Crime,Thriller",5.7,44816,55000000,9489829,22597969,-32402031,-0.5891278363636364
Dredd,95.0,"Action,Crime,Sci-Fi",7.1,234616,45000000,13414714,41467606,-3532394,-0.07849764444444444
Baywatch,116.0,"Action,Comedy,Crime",5.6,137528,60000000,58060186,175863783,115863783,1.93106305
Only God Forgives,90.0,"Crime,Drama",5.7,100318,4800000,775849,4494560,-305440,-0.06363333333333333
Can You Ever Forgive Me?,106.0,"Biography,Comedy,Crime",7.2,29473,10000000,8803865,11752387,1752387,0.1752387
Logan Lucky,118.0,"Comedy,Crime,Drama",7.0,105966,29000000,27778642,44264271,15264271,0.5263541724137931
Dope,103.0,"Comedy,Crime,Drama",7.2,76557,7000000,17506470,18190831,11190831,1.598690142857143
Tower Heist,104.0,"Action,Comedy,Crime",6.2,125102,85000000,78046570,150422946,65422946,0.7696817176470588
The Heat,117.0,"Action,Comedy,Crime",6.6,153501,43000000,159581587,229727774,186727774,4.342506372093023
Legend,132.0,"Biography,Crime,Drama",7.0,138947,25000000,15502112,23506237,-1493763,-0.05975052
Machete Kills,107.0,"Action,Crime,Sci-Fi",5.6,69968,20000000,8008161,18273009,-1726991,-0.08634955
Muppets Most Wanted,107.0,"Adventure,Comedy,Crime",6.4,29018,55000000,51178893,79312301,24312301,0.44204183636363636
The Family,111.0,"Comedy,Crime,Thriller",6.3,102576,30000000,36918811,51078541,21078541,0.7026180333333333
Furious 7,137.0,"Action,Crime,Thriller",7.2,335074,190000000,353007020,1518722794,1328722794,6.9932778631578945
The Girl on the Train,112.0,"Crime,Drama,Mystery",6.5,150977,45000000,75395035,174278214,129278214,2.8728492
Proud Mary,89.0,"Action,Crime,Drama",4.9,6805,30000000,20868638,21709539,-8290461,-0.2763487
30 Minutes or Less,83.0,"Action,Comedy,Crime",6.1,87254,28000000,37053924,40966716,12966716,0.463097
Deadfall,95.0,"Crime,Drama,Thriller",6.3,36491,6000000,66351,1673635,-4326365,-0.7210608333333334
Triple 9,115.0,"Crime,Thriller",6.3,60369,20000000,12639297,25943792,5943792,0.2971896
Death Wish,107.0,"Action,Crime,Drama",6.4,50279,30000000,34017028,48575965,18575965,0.6191988333333334
The American,105.0,"Crime,Drama,Thriller",6.3,86863,20000000,35606376,67950723,47950723,2.39753615
The Next Three Days,133.0,"Action,Crime,Drama",7.4,168066,30000000,21148651,67255916,37255916,1.2418638666666666
The Hate U Give,133.0,"Crime,Drama",7.3,17583,23000000,29719483,35067665,12067665,0.5246810869565217
Red State,88.0,"Action,Crime,Horror",6.2,59266,4000000,1065429,1983596,-2016404,-0.504101
Child 44,137.0,"Crime,Drama,History",6.5,59477,50000000,1224330,8004221,-41995779,-0.83991558
The Iceman,106.0,"Biography,Crime,Drama",6.9,65571,10000000,1930282,3623609,-6376391,-0.6376391
Eden,98.0,"Crime,Drama",6.7,7709,2300000,0,0,-2300000,-1.0
Dheepan,115.0,"Crime,Drama",7.2,12312,9000000,248795,7704357,-1295643,-0.14396033333333333
"Three Billboards Outside Ebbing, Missouri",115.0,"Crime,Drama",8.2,344047,12000000,54513740,160191915,148191915,12.34932625
Robot & Frank,89.0,"Comedy,Crime,Drama",7.1,59229,2500000,3317468,4934356,2434356,0.9737424
No Good Deed,84.0,"Action,Crime,Drama",5.6,16045,13200000,52543632,54323210,41123210,3.115394696969697
Get Hard,100.0,"Comedy,Crime",6.0,111187,40000000,90411453,106511453,66511453,1.662786325
Inferno,121.0,"Action,Adventure,Crime",6.2,138978,75000000,34343574,219519367,144519367,1.9269248933333334
Sicario,121.0,"Action,Crime,Drama",7.6,328548,30000000,46889293,84393749,54393749,1.8131249666666667
A Simple Favor,117.0,"Comedy,Crime,Drama",6.9,83338,20000000,53548586,97628717,77628717,3.88143585
Casino Jack,108.0,"Biography,Comedy,Crime",6.2,16191,12500000,2039869,2272186,-10227814,-0.81822512
Lawless,116.0,"Crime,Drama",7.3,214055,26000000,37397291,54393687,28393687,1.0920648846153846
Animal Kingdom,113.0,"Crime,Drama",7.3,51576,4200000,1044039,8078683,3878683,0.9234959523809524
Cop Out,107.0,"Action,Comedy,Crime",5.6,81656,37000000,44875481,55909910,18909910,0.5110786486486486
Ride Along,99.0,"Action,Comedy,Crime",6.2,94529,25000000,134202565,153733800,128733800,5.149352
Man on a Ledge,102.0,"Action,Adventure,Crime",6.6,137507,42000000,18620000,49621440,7621440,0.18146285714285715
J. Edgar,137.0,"Biography,Crime,Drama",6.6,115925,35000000,37306030,84606030,49606030,1.4173151428571429
Skin Trade,96.0,"Action,Crime,Thriller",5.7,6942,9000000,1242,1242,-8998758,-0.999862
The Gunman,115.0,"Action,Crime,Drama",5.8,36053,40000000,10664749,18594227,-21405773,-0.535144325
Let's Kill Ward's Wife,82.0,"Comedy,Crime",5.4,5164,5000000,0,0,-5000000,-1.0
The Killer Inside Me,109.0,"Crime,Drama,Horror",6.1,31727,13000000,217277,3617277,-9382723,-0.721747923076923
Side Effects,106.0,"Crime,Drama,Mystery",7.1,168466,30000000,32172757,66742138,36742138,1.2247379333333333
American Heist,94.0,"Action,Crime,Drama",5.1,15547,10000000,0,2341218,-7658782,-0.7658782
Regression,106.0,"Crime,Horror,Mystery",5.7,33335,20000000,55039,15824374,-4175626,-0.2087813
Patriots Day,133.0,"Action,Crime,Drama",7.4,76204,40000000,31886361,52837989,12837989,0.320949725
The Mechanic,93.0,"Action,Crime,Thriller",6.6,141254,42500000,29121498,76347393,33847393,0.7964092470588235
Keanu,100.0,"Action,Comedy,Crime",6.3,41560,15000000,20591853,20688141,5688141,0.3792094
Free Fire,91.0,"Action,Comedy,Crime",6.4,35954,10000000,1799322,3793739,-6206261,-0.6206261
Repo Men,111.0,"Action,Crime,Sci-Fi",6.3,96144,32000000,13942007,18195238,-13804762,-0.4313988125
Holmes & Watson,90.0,"Adventure,Comedy,Crime",3.8,17661,42000000,30568743,41926605,-73395,-0.0017475
Looper,113.0,"Action,Crime,Drama",7.4,500595,30000000,66486205,170466405,140466405,4.6822135
Secret in Their Eyes,111.0,"Crime,Drama,Mystery",6.3,37455,20000000,20180155,32608019,12608019,0.63040095
Destroyer,121.0,"Action,Crime,Drama",6.2,13683,9000000,1533324,3681096,-5318904,-0.5909893333333334
Getaway,90.0,"Action,Crime,Thriller",4.4,22157,18000000,10501938,11813989,-6186011,-0.3436672777777778
Rough Night,101.0,"Comedy,Crime,Thriller",5.2,39447,20000000,22105643,46844357,26844357,1.34221785
Big Eyes,106.0,"Biography,Crime,Drama",7.0,77447,10000000,14482031,27317872,17317872,1.7317872
Black Mass,123.0,"Biography,Crime,Drama",6.9,155847,53000000,62575678,98837872,45837872,0.8648655094339622
Safe House,115.0,"Action,Adventure,Crime",6.8,192655,85000000,126181630,208542162,123542162,1.4534372
Savages,131.0,"Crime,Drama,Thriller",6.5,115793,45000000,47323100,82513490,37513490,0.8336331111111112
Safe,94.0,"Action,Crime,Thriller",6.5,96388,33000000,17142080,41495213,8495213,0.25743069696969695
The Snowman,119.0,"Crime,Drama,Mystery",5.1,47890,35000000,6670765,43226146,8226146,0.23503274285714285
Killing Them Softly,97.0,"Crime,Thriller",6.2,124086,15000000,14945541,39238443,24238443,1.6158962
The Fate of the Furious,136.0,"Action,Crime,Thriller",6.7,179774,250000000,225764765,1234846267,984846267,3.939385068
"Roman J. Israel, Esq.",122.0,"Crime,Drama,Thriller",6.4,23632,22000000,11962712,12967012,-9032988,-0.41059036363636364
Spotlight,129.0,"Crime,Drama",8.1,365110,20000000,45055776,92088460,72088460,3.604423
Dead Man Down,118.0,"Action,Crime,Drama",6.5,61238,30000000,10895295,19599974,-10400026,-0.34666753333333333
Live by Night,129.0,"Action,Crime,Drama",6.4,47243,65000000,10378555,21774432,-43225568,-0.6650087384615384
Point Break,114.0,"Action,Crime,Sport",5.3,53802,100000000,28782481,126704591,26704591,0.26704591
Focus,105.0,"Comedy,Crime,Drama",6.6,192147,65000000,53862963,168065700,103065700,1.5856261538461538
Joe,117.0,"Crime,Drama",6.9,42825,4000000,373375,373375,-3626625,-0.90665625
Kill the Messenger,112.0,"Biography,Crime,Drama",7.0,41231,5000000,2450846,6656705,1656705,0.331341
Date Night,88.0,"Comedy,Crime,Romance",6.3,144683,55000000,98711404,152269033,97269033,1.7685278727272726
The Perfect Host,93.0,"Comedy,Crime,Thriller",6.8,23378,1000000,48764,51587,-948413,-0.948413
The Infiltrator,127.0,"Biography,Crime,Drama",7.0,61547,47500000,15436808,20718104,-26781896,-0.5638293894736842
Kidnap,95.0,"Crime,Drama,Thriller",5.9,28898,21000000,30718107,34836080,13836080,0.6588609523809524
Redemption,100.0,"Action,Crime,Drama",6.2,61317,23000000,36686,13593473,-9406527,-0.4089794347826087
Zulu,110.0,"Crime,Drama,Thriller",6.7,16607,16000000,0,1844228,-14155772,-0.88473575
22 Jump Street,112.0,"Action,Comedy,Crime",7.0,319504,50000000,191719337,331333876,281333876,5.62667752
Need for Speed,132.0,"Action,Crime,Thriller",6.5,154909,66000000,43568507,194169619,128169619,1.9419639242424243
Veronica Mars,107.0,"Crime,Drama,Mystery",6.8,46751,6000000,3322127,3485383,-2514617,-0.4191028333333333
Jigsaw,92.0,"Crime,Horror,Mystery",5.8,57184,10000000,38052832,102445196,92445196,9.2445196
Nerve,96.0,"Action,Adventure,Crime",6.5,102782,20000000,38583626,70652284,50652284,2.5326142
Thoroughbreds,92.0,"Comedy,Crime,Drama",6.7,25098,5000000,3072605,3187302,-1812698,-0.3625396
The House,88.0,"Comedy,Crime",5.6,33365,40000000,25584504,31192425,-8807575,-0.220189375
The Lincoln Lawyer,118.0,"Crime,Drama,Thriller",7.3,196109,40000000,58009200,87145086,47145086,1.17862715
Premium Rush,91.0,"Action,Crime,Thriller",6.5,105279,35000000,20275446,31393201,-3606799,-0.1030514
In Time,109.0,"Action,Crime,Drama",6.7,346077,35000000,37553932,165103952,130103952,3.7172557714285714
Stolen,96.0,"Action,Crime,Thriller",5.5,41313,35000000,289773,17967746,-17032254,-0.48663582857142856
End of Watch,109.0,"Action,Crime,Drama",7.6,211308,15000000,41003371,57586606,42586606,2.8391070666666667
Plastic,102.0,"Action,Comedy,Crime",6.0,7234,10000000,0,575371,-9424629,-0.9424629
Paul Blart: Mall Cop 2,94.0,"Action,Comedy,Crime",4.4,30828,38000000,71091594,107650646,69650646,1.8329117368421053
Breaking In,88.0,"Action,Crime,Drama",5.4,10154,6000000,46840590,51411620,45411620,7.568603333333333
The Town,125.0,"Crime,Drama,Thriller",7.6,322524,37000000,92186262,152566881,115566881,3.1234292162162163
Brick Mansions,90.0,"Action,Crime",5.7,37528,28000000,20396829,73421224,45421224,1.6221865714285715
Fast Five,130.0,"Action,Crime,Thriller",7.3,329892,125000000,210031325,630163454,505163454,4.041307632
The Judge,141.0,"Crime,Drama",7.4,162952,50000000,47119388,76119388,26119388,0.52238776
A Most Wanted Man,122.0,"Crime,Drama,Thriller",6.8,67914,15000000,17237855,36068890,21068890,1.4045926666666666
Mortdecai,107.0,"Action,Comedy,Crime",5.5,61366,60000000,7696134,30396134,-29603866,-0.4933977666666667
Murder on the Orient Express,114.0,"Crime,Drama,Mystery",6.5,178603,55000000,102826543,345922730,290922730,5.289504181818182
BlacKkKlansman,135.0,"Biography,Crime,Drama",7.5,149005,15000000,49275340,93017335,78017335,5.201155666666667
The Wolf of Wall Street,180.0,"Biography,Crime,Drama",8.2,1035358,100000000,116900694,389870414,289870414,2.89870414
Compliance,90.0,"Biography,Crime,Drama",6.4,28703,270000,319285,830700,560700,2.0766666666666667
The Grand Budapest Hotel,99.0,"Adventure,Comedy,Crime",8.1,633604,31000000,59076019,163981261,132981261,4.289718096774194
Gangster Squad,113.0,"Action,Crime,Drama",6.7,195560,60000000,46000903,104100903,44100903,0.73501505
Alex Cross,101.0,"Action,Crime,Mystery",5.1,30951,35000000,25888412,35426759,426759,0.012193114285714285
Ride Along 2,102.0,"Action,Comedy,Crime",5.9,48688,40000000,90862685,124827316,84827316,2.1206829
Heist,93.0,"Action,Crime,Thriller",6.1,24740,35000000,23483357,28906817,-6093183,-0.17409094285714286
The Frozen Ground,105.0,"Crime,Drama,Mystery",6.4,51915,19200000,0,5617460,-13582540,-0.7074239583333334
Identity Thief,111.0,"Adventure,Comedy,Crime",5.7,115624,35000000,134506920,175361578,140361578,4.0103308
The November Man,108.0,"Action,Crime,Thriller",6.3,59293,15000000,25018119,34820335,19820335,1.3213556666666666
Sicario: Day of the Soldado,122.0,"Action,Crime,Drama",7.1,95650,35000000,50065850,75885196,40885196,1.168148457142857
Bad Times at the El Royale,141.0,"Crime,Drama,Mystery",7.1,86318,32000000,17839115,29204379,-2795621,-0.08736315625
Parker,118.0,"Action,Crime,Thriller",6.2,105529,35000000,17616641,48543388,13543388,0.38695394285714285
The Gambler,111.0,"Crime,Drama,Thriller",6.0,59995,25000000,33680992,38718031,13718031,0.54872124
The Counselor,117.0,"Crime,Drama,Thriller",5.3,92096,25000000,16973715,71009334,46009334,1.84037336
Runner Runner,88.0,"Crime,Thriller",5.6,58235,30000000,19316646,60512680,30512680,1.0170893333333333
Ain't Them Bodies Saints,96.0,"Crime,Drama,Romance",6.4,19464,5000000,391611,1075009,-3924991,-0.7849982
Dom Hemingway,93.0,"Comedy,Crime,Drama",6.2,24557,7000000,523511,1857458,-5142542,-0.7346488571428571
The Dirties,83.0,"Crime,Drama",6.8,5728,55000,0,0,-55000,-1.0
Hitman: Agent 47,96.0,"Action,Adventure,Crime",5.7,80510,35000000,22467450,82182803,47182803,1.3480800857142856
Nightcrawler,117.0,"Crime,Drama,Thriller",7.9,404476,8500000,32381218,50334418,41834418,4.921696235294117
Hot Pursuit,87.0,"Action,Comedy,Crime",5.1,44723,35000000,34580201,45671512,10671512,0.30490034285714285
Baby Driver,113.0,"Action,Crime,Drama",7.6,363977,34000000,107825862,228104185,194104185,5.708946617647059
"Big Mommas: Like Father, Like Son",107.0,"Action,Comedy,Crime",4.4,23520,32000000,37915414,82332450,50332450,1.5728890625
The Drop,106.0,"Crime,Drama",7.1,132161,12600000,10724389,19054534,6454534,0.5122646031746032
Inherent Vice,148.0,"Comedy,Crime,Drama",6.7,83346,20000000,8110975,14772346,-5227654,-0.2613827
The Perfect Guy,100.0,"Crime,Drama,Horror",5.6,8998,18000000,57027435,60278166,42278166,2.348787
Trash,114.0,"Adventure,Crime,Drama",7.2,18690,12000000,17484,6553186,-5446814,-0.4539011666666667
The Accountant,128.0,"Action,Crime,Drama",7.3,233022,40000000,86260045,152962083,112962083,2.824052075
Wild Card,92.0,"Action,Crime,Drama",5.6,46463,30000000,3200,4315789,-25684211,-0.8561403666666667
Blue Ruin,90.0,"Crime,Drama,Thriller",7.1,58811,420000,258384,437002,17002,0.04048095238095238
John Wick,101.0,"Action,Crime,Thriller",7.4,449942,30000000,43037835,76235001,46235001,1.5411667
The Transporter Refueled,96.0,"Action,Adventure,Crime",5.2,36201,22000000,16029670,69698495,47698495,2.168113409090909
Marshall,118.0,"Biography,Crime,Drama",7.2,14419,12000000,10051659,10116816,-1883184,-0.156932
Trance,101.0,"Crime,Drama,Mystery",6.9,104951,16000000,2322593,22594052,6594052,0.41212825
The Nice Guys,116.0,"Action,Comedy,Crime",7.4,240337,50000000,36261763,59596747,9596747,0.19193494
The Sisters Brothers,122.0,"Adventure,Comedy,Crime",7.0,32135,38000000,3143056,13143056,-24856944,-0.6541301052631578
Sin City: A Dame to Kill For,102.0,"Crime,Thriller",6.5,140666,65000000,13757804,40650842,-24349158,-0.3746024307692308
Dylan Dog: Dead of Night,107.0,"Action,Comedy,Crime",5.1,14120,20000000,1186538,6093725,-13906275,-0.69531375
Widows,129.0,"Crime,Drama,Thriller",7.0,61615,40000000,42402632,73866088,33866088,0.8466522
The Losers,97.0,"Action,Adventure,Crime",6.4,83876,25000000,23591432,29863840,4863840,0.1945536
The Mule,103.0,"Comedy,Crime,Drama",6.3,5788,50000000,103804407,170857676,120857676,2.41715352
The Mule,116.0,"Crime,Drama,Thriller",7.1,58955,50000000,103804407,170857676,120857676,2.41715352
Money Monster,98.0,"Crime,Drama,Thriller",6.5,86607,27000000,41012075,93466095,66466095,2.461707222222222
Takers,107.0,"Action,Crime,Thriller",6.2,53377,32000000,57744720,70587268,38587268,1.205852125
Conviction,107.0,"Biography,Crime,Drama",7.2,39771,12500000,6797696,11826980,-673020,-0.0538416
Gotti,112.0,"Biography,Crime,Drama",4.8,10358,10000000,4286367,6089100,-3910900,-0.39109
We're the Millers,110.0,"Comedy,Crime",7.0,371759,37000000,150394119,267816276,230816276,6.23827772972973
The Hurricane Heist,103.0,"Action,Adventure,Crime",5.1,15326,40000000,6115824,30963684,-9036316,-0.2259079
Bright,117.0,"Action,Crime,Fantasy",6.4,147834,90000000,0,0,-90000000,-1.0
Cold Pursuit,119.0,"Action,Crime,Drama",6.2,27648,60000000,32138862,62599159,2599159,0.04331931666666667
RED 2,116.0,"Action,Comedy,Crime",6.6,148846,84000000,53262560,141507355,57507355,0.6846113690476191
Blackhat,133.0,"Action,Crime,Thriller",5.4,48427,70000000,8005980,19665004,-50334996,-0.7190713714285715
Highway,133.0,"Crime,Drama,Romance",7.7,23434,2000000,0,0,-2000000,-1.0
I Am Wrath,92.0,"Action,Crime,Drama",5.4,11198,18000000,0,309608,-17690392,-0.9827995555555555
The Sweeney,112.0,"Action,Crime,Drama",6.1,18095,4500000,26345,8000366,3500366,0.7778591111111111
Edge of Darkness,117.0,"Crime,Drama,Mystery",6.6,84753,60000000,43313890,82812456,22812456,0.3802076
Killer Elite,116.0,"Action,Crime,Thriller",6.5,117711,70000000,25124986,65409046,-4590954,-0.06558505714285714
The Girl with the Dragon Tattoo,158.0,"Crime,Drama,Mystery",7.8,387580,90000000,102515793,239373970,149373970,1.6597107777777778
Trespass,91.0,"Crime,Drama,Thriller",5.3,39404,35000000,16816,786532,-34213468,-0.9775276571428572
Criminal Activities,94.0,"Crime,Drama,Thriller",5.8,7739,7000000,0,386744,-6613256,-0.9447508571428571
White Boy Rick,111.0,"Crime,Drama",6.4,16255,30000000,24004833,25947983,-4052017,-0.13506723333333334
Unfriended: Dark Web,92.0,"Crime,Horror,Mystery",5.9,13822,1000000,8866745,16434588,15434588,15.434588
Ca$h,108.0,"Crime,Thriller",6.0,8605,13700000,0,11738256,-1961744,-0.14319299270072994
Contraband,109.0,"Action,Crime,Drama",6.5,111709,25000000,66528000,98406855,73406855,2.9362742
The Son of No One,90.0,"Action,Crime,Drama",5.1,15743,15000000,30680,1148578,-13851422,-0.9234281333333333
The Guard,96.0,"Comedy,Crime,Thriller",7.3,75183,6000000,5359774,21197454,15197454,2.532909
The Call,94.0,"Crime,Drama,Horror",6.7,103780,12800000,51872378,69821476,57021476,4.4548028125
Misconduct,106.0,"Crime,Drama,Mystery",5.3,13550,11000000,0,2352511,-8647489,-0.7861353636363636
Escobar: Paradise Lost,120.0,"Crime,Drama,History",6.5,19419,17000000,195792,3917679,-13082321,-0.769548294117647
The Conspirator,122.0,"Crime,Drama,History",6.9,26416,25000000,11538204,15907411,-9092589,-0.36370356
Brighton Rock,111.0,"Crime,Drama,Thriller",5.7,5784,11000000,229653,229653,-10770347,-0.9791224545454545
Prisoners,153.0,"Crime,Drama,Mystery",8.1,526273,46000000,61002302,113402302,67402302,1.4652674347826087
Hesher,106.0,"Comedy,Crime,Drama",7.0,48483,7000000,382946,382946,-6617054,-0.9452934285714286
The Paperboy,107.0,"Crime,Drama,Mystery",5.8,33940,12500000,677200,4027663,-8472337,-0.67778696
Machine Gun Preacher,129.0,"Action,Biography,Crime",6.8,60074,30000000,538690,3721988,-26278012,-0.8759337333333334
Now You See Me,115.0,"Crime,Mystery,Thriller",7.3,553156,75000000,117723989,342769200,267769200,3.570256
The Place Beyond the Pines,140.0,"Crime,Drama,Thriller",7.3,226765,15000000,21403519,47011449,32011449,2.1340966
Pain & Gain,129.0,"Action,Comedy,Crime",6.4,187820,26000000,49875291,81275291,55275291,2.125972730769231
Spring Breakers,94.0,"Comedy,Crime,Drama",5.3,126504,5000000,14124286,31149251,26149251,5.2298502
Collide,99.0,"Action,Crime,Thriller",5.7,13288,29200000,2280004,5466698,-23733302,-0.8127843150684931
Going in Style,96.0,"Comedy,Crime",6.6,66418,24000000,45018541,78672579,54672579,2.278024125
Criminal,113.0,"Action,Crime,Drama",6.3,51666,31500000,14708696,38771262,7271262,0.23083371428571428
Survivor,96.0,"Action,Crime,Thriller",5.6,28614,20000000,0,1703281,-18296719,-0.91483595
The Equalizer,132.0,"Action,Crime,Thriller",7.2,302302,55000000,101530738,192903624,137903624,2.507338618181818
The Rover,103.0,"Action,Crime,Drama",6.4,40576,8500000,1109199,3180252,-5319748,-0.625852705882353
The Act of Killing,117.0,"Crime,Documentary",8.2,31115,1000000,486919,1227316,227316,0.227316
A Most Violent Year,125.0,"Crime,Drama,Thriller",7.0,60165,20000000,5749134,8846875,-11153125,-0.55765625
The Hateful Eight,168.0,"Crime,Drama,Mystery",7.8,434966,62000000,54117416,147864886,85864886,1.3849175161290324
Four Lions,97.0,"Comedy,Crime,Drama",7.3,66209,3750000,310007,2436111,-1313889,-0.3503704
Point Blank,81.0,"Action,Crime,Drama",6.8,12706,3000000,0,0,-3000000,-1.0
Bernie,99.0,"Biography,Comedy,Crime",6.8,53765,6000000,9204489,10106975,4106975,0.6844958333333333
Killer Joe,102.0,"Crime,Drama,Thriller",6.7,67842,10000000,1291645,4659110,-5340890,-0.534089
RoboCop,117.0,"Action,Crime,Sci-Fi",6.2,205798,120000000,58607007,242981799,122981799,1.024848325
Den of Thieves,140.0,"Action,Crime,Drama",7.0,69648,30000000,44947622,80131391,50131391,1.6710463666666666
Kill the Irishman,106.0,"Biography,Crime,Drama",7.1,41504,12000000,1188194,1188194,-10811806,-0.9009838333333333
One for the Money,91.0,"Action,Comedy,Crime",5.3,38473,42000000,26414527,36197221,-5802779,-0.13816140476190475
American Hustle,138.0,"Crime,Drama",7.2,418221,40000000,150117807,257878294,217878294,5.44695735
Miss Bala,113.0,"Crime,Drama,Thriller",6.5,8092,15000000,14998027,15362298,362298,0.0241532
Seven Psychopaths,110.0,"Comedy,Crime",7.2,223493,13500000,15024049,33035736,19535736,1.4470915555555555
Horrible Bosses 2,108.0,"Comedy,Crime",6.3,144442,40000000,54445357,105945357,65945357,1.648633925
Cheap Thrills,88.0,"Comedy,Crime,Drama",6.7,16429,100000,59424,59424,-40576,-0.40576
All Good Things,101.0,"Crime,Drama,Mystery",6.3,49684,20000000,582024,873617,-19126383,-0.95631915
2 Guns,109.0,"Action,Comedy,Crime",6.7,182025,61000000,75612460,132493015,71493015,1.1720166393442624
The Other Guys,107.0,"Action,Comedy,Crime",6.7,221664,100000000,119219978,170936470,70936470,0.7093647
Faster,98.0,"Action,Crime,Drama",6.5,93618,24000000,23240020,35792945,11792945,0.49137270833333335
Trust,106.0,"Crime,Drama,Thriller",6.9,39422,4000000,120016,120016,-3879984,-0.969996
Sabotage,109.0,"Action,Crime,Drama",5.7,55597,35000000,10508518,18376443,-16623557,-0.4749587714285714
Blood Ties,127.0,"Action,Crime,Drama",6.5,17771,26000000,42472,2923959,-23076041,-0.8875400384615385
Chappie,120.0,"Action,Crime,Drama",6.8,213733,49000000,31569268,105002056,56002056,1.1428991020408164
Cop Car,88.0,"Crime,Thriller",6.3,27081,5000000,134552,143658,-4856342,-0.9712684
Peppermint,101.0,"Action,Crime,Drama",6.5,35854,25000000,35418723,51800758,26800758,1.07203032
Drive,100.0,"Crime,Drama",7.8,521495,15000000,35060689,81357930,66357930,4.423862
Freaky Deaky,90.0,"Comedy,Crime,Thriller",6.1,6088,6000000,0,0,-6000000,-1.0
Game Night,100.0,"Action,Comedy,Crime",7.0,163279,37000000,69179066,117378084,80378084,2.1723806486486485
