movie,runtime_minutes,genres,averagerating,numvotes,production_budget,domestic_gross,worldwide_gross,net_revenue,ROI%
Moneyball,133.0,"Biography,Drama,Sport",7.6,326657,50000000,75605492,111300835,61300835,1.2260167
Hereafter,129.0,"Drama,Fantasy,Romance",6.5,87288,50000000,32746941,108660270,58660270,1.1732054
Aloha,105.0,"Comedy,Drama,Romance",5.4,54646,37000000,21052030,25387091,-11612909,-0.3138624054054054
Sex and the City 2,146.0,"Comedy,Drama,Romance",4.4,69199,95000000,95347692,294680778,199680778,2.1019029263157893
Small Apartments,96.0,"Comedy,Crime,Drama",6.1,6688,2000000,0,0,-2000000,-1.0
Remember Me,113.0,"Drama,Romance",7.1,129443,16000000,19068240,56506120,40506120,2.5316325
Captain Phillips,134.0,"Biography,Drama,Thriller",7.8,387402,55000000,107136417,220648184,165648184,3.0117851636363637
Another Earth,92.0,"Drama,Romance,Sci-Fi",7.0,85839,175000,1321194,2102779,1927779,11.01588
House at the End of the Street,101.0,"Drama,Horror,Thriller",5.6,66303,6900000,31611916,44103982,37203982,5.391881449275362
Chasing Mavericks,116.0,"Biography,Drama,Sport",7.2,28994,20000000,6002756,8300821,-11699179,-0.58495895
Jumping the Broom,112.0,"Comedy,Drama",5.7,9089,7000000,37295394,38158601,31158601,4.4512287142857145
My Week with Marilyn,99.0,"Biography,Drama",7.0,79337,10000000,14597405,34240572,24240572,2.4240572
Polisse,127.0,"Crime,Drama",7.3,12506,8900000,176988,22744132,13844132,1.5555204494382022
The Spectacular Now,95.0,"Comedy,Drama,Romance",7.1,133887,2500000,6852971,6916951,4416951,1.7667804
Eat Pray Love,133.0,"Drama,Romance",5.8,77709,60000000,80574010,206598789,146598789,2.44331315
Letters to Juliet,105.0,"Adventure,Comedy,Drama",6.6,86137,30000000,53032453,82148538,52148538,1.7382846
Nine Dead,98.0,"Crime,Drama,Horror",5.5,11358,2000000,0,0,-2000000,-1.0
Shanghai,105.0,"Crime,Drama,Mystery",6.4,8662,50000000,46425,15505922,-34494078,-0.68988156
A Little Bit of Heaven,106.0,"Comedy,Drama,Fantasy",6.3,26441,12500000,10011,1100287,-11399713,-0.91197704
The Host,125.0,"Action,Adventure,Drama",5.9,105633,50000000,26623701,64477051,14477051,0.28954102
The Grey,117.0,"Action,Adventure,Drama",6.8,228798,25000000,51580136,81249176,56249176,2.24996704
Anna,99.0,"Drama,Mystery,Sci-Fi",6.5,19733,4357373,0,1200000,-3157373,-0.7246047102233387
Madea's Big Happy Family,106.0,"Comedy,Drama",4.7,6996,25000000,53345287,54160818,29160818,1.16643272
Lincoln,150.0,"Biography,Drama,History",7.4,228701,65000000,182207973,273346281,208346281,3.2053274
The Karate Kid,140.0,"Action,Drama,Family",6.2,146401,40000000,176591618,351774938,311774938,7.79437345
Incendies,131.0,"Drama,Mystery,War",8.3,124156,6800000,6857096,16038343,9238343,1.3585798529411766
Never Let Me Go,103.0,"Drama,Romance,Sci-Fi",7.1,130084,15000000,2434652,11173718,-3826282,-0.25508546666666665
The Divide,112.0,"Drama,Horror,Sci-Fi",5.8,33603,3000000,18000,156362,-2843638,-0.9478793333333333
Beautiful Creatures,124.0,"Drama,Fantasy,Romance",6.2,79764,50000000,19452138,60282876,10282876,0.20565752
October Baby,107.0,Drama,6.8,6903,1000000,5355847,5391992,4391992,4.391992
Danny Collins,106.0,"Biography,Comedy,Drama",7.0,27435,10000000,5637066,8465845,-1534155,-0.1534155
The Book of Eli,118.0,"Action,Adventure,Drama",6.9,271307,80000000,94835059,158750817,78750817,0.9843852125
Winchester,99.0,"Biography,Drama,Fantasy",5.4,24351,3500000,25091816,44378040,40878040,11.67944
Blue Valentine,112.0,"Drama,Romance",7.4,170089,1000000,9737892,16566240,15566240,15.56624
A Nightmare on Elm Street,95.0,"Crime,Drama,Horror",5.2,85497,35000000,63075011,117729621,82729621,2.363703457142857
10 Cloverfield Lane,103.0,"Drama,Horror,Mystery",7.2,260383,5000000,72082999,108286422,103286422,20.6572844
12 Strong,130.0,"Action,Drama,History",6.6,50155,35000000,45819713,71118378,36118378,1.0319536571428571
One Day,107.0,"Drama,Romance",7.0,128094,15000000,13843771,59168692,44168692,2.9445794666666667
Some Guy Who Kills People,97.0,"Comedy,Crime,Drama",6.3,5111,300000,0,0,-300000,-1.0
Tiny Furniture,98.0,"Comedy,Drama,Romance",6.2,13397,50000,391674,424149,374149,7.48298
Larry Crowne,98.0,"Comedy,Drama,Romance",6.1,58927,30000000,35608245,61449135,31449135,1.0483045
Act of Valor,110.0,"Action,Adventure,Drama",6.5,63787,12000000,70012847,82497035,70497035,5.874752916666667
Shame,101.0,Drama,7.2,171353,6500000,4002293,20412841,13912841,2.1404370769230767
The First Time,95.0,"Comedy,Drama,Romance",6.9,62589,2000000,17061,17061,-1982939,-0.9914695
A Walk Among the Tombstones,114.0,"Action,Crime,Drama",6.5,105116,28000000,26017685,62108587,34108587,1.2181638214285715
Dracula Untold,92.0,"Action,Drama,Fantasy",6.3,164829,70000000,55991880,220241723,150241723,2.1463103285714284
The Runaways,106.0,"Biography,Drama,Music",6.6,43792,9500000,3573673,5278632,-4221368,-0.4443545263157895
The Big Wedding,89.0,"Comedy,Drama,Romance",5.6,44221,32500000,21819348,48425971,15925971,0.4900298769230769
Grace of Monaco,103.0,"Biography,Drama,Romance",5.7,16685,30000000,0,25199891,-4800109,-0.16000363333333334
Hell or High Water,102.0,"Action,Crime,Drama",7.6,176469,12000000,27007844,37584304,25584304,2.1320253333333334
Captive,97.0,"Action,Crime,Drama",5.4,6017,2000000,2583301,2791973,791973,0.3959865
Still Alice,101.0,Drama,7.5,116832,5000000,18656400,41699612,36699612,7.3399224
Only the Brave,134.0,"Action,Biography,Drama",7.7,45482,38000000,18340051,24555177,-13444823,-0.3538111315789474
42,128.0,"Biography,Drama,Sport",7.5,77703,31000000,95020213,97470701,66470701,2.1442161612903226
The Descendants,115.0,"Comedy,Drama",7.3,223464,20000000,82624961,175507800,155507800,7.77539
You Will Meet a Tall Dark Stranger,98.0,"Comedy,Drama,Romance",6.3,41608,15000000,3247816,34247816,19247816,1.2831877333333332
Diary of a Wimpy Kid,94.0,"Comedy,Drama,Family",6.2,38640,15000000,64003625,76954311,61954311,4.1302874
Kites,123.0,"Action,Drama,Romance",6.1,11353,9200000,1685269,17155193,7955193,0.8646948913043478
Out of the Furnace,116.0,"Crime,Drama,Thriller",6.8,99037,22000000,11330849,15434375,-6565625,-0.2984375
Ghost in the Shell,107.0,"Action,Drama,Sci-Fi",6.4,176499,110000000,40563557,167910690,57910690,0.5264608181818182
Immortals,110.0,"Action,Drama,Fantasy",6.0,152992,75000000,83504017,211562435,136562435,1.8208324666666666
The Devil's Double,109.0,"Biography,Drama,Thriller",7.1,58342,19100000,1361512,5965646,-13134354,-0.6876625130890053
Oldboy,104.0,"Action,Drama,Mystery",5.8,63231,3000000,707391,6239723,3239723,1.0799076666666667
The Twilight Saga: Eclipse,124.0,"Adventure,Drama,Fantasy",5.0,211733,68000000,300531751,706102828,638102828,9.383865117647058
If I Stay,107.0,"Drama,Fantasy,Music",6.8,107625,11000000,50474843,78356170,67356170,6.1232881818181815
Submarine,97.0,"Comedy,Drama,Romance",7.3,79810,1900000,467602,4581937,2681937,1.4115457894736843
The Help,146.0,Drama,8.1,392699,25000000,169705587,213120004,188120004,7.52480016
Stake Land,98.0,"Drama,Horror,Sci-Fi",6.5,38749,4000000,33245,679482,-3320518,-0.8301295
The Dilemma,111.0,"Comedy,Drama",5.3,48148,70000000,48475290,70546865,546865,0.007812357142857143
Unbroken,137.0,"Biography,Drama,Sport",7.2,129981,65000000,115637895,163527824,98527824,1.5158126769230769
Instant Family,118.0,"Comedy,Drama",7.4,46728,48000000,67363237,119736188,71736188,1.4945039166666667
Before We Go,95.0,"Comedy,Drama,Romance",6.8,45181,3000000,37151,483938,-2516062,-0.8386873333333333
Rings,102.0,"Drama,Horror,Mystery",4.5,34151,25000000,27793018,82917283,57917283,2.31669132
Footloose,113.0,"Comedy,Drama,Music",5.9,43251,24000000,51802742,62989834,38989834,1.6245764166666667
We Bought a Zoo,124.0,"Comedy,Drama,Family",7.1,126849,50000000,75624550,118729073,68729073,1.37458146
Barney's Version,134.0,"Comedy,Drama",7.3,23058,30000000,7502560,8845575,-21154425,-0.7051475
Soul Surfer,112.0,"Biography,Drama,Family",7.1,41659,18000000,43853424,47158652,29158652,1.619925111111111
Damsels in Distress,99.0,"Comedy,Drama,Romance",5.7,8794,3000000,1007535,1324299,-1675701,-0.558567
The Way Way Back,103.0,"Comedy,Drama",7.4,132642,5000000,21502690,26853810,21853810,4.370762
Kill List,95.0,"Crime,Drama,Horror",6.4,32807,800000,29063,462206,-337794,-0.4222425
The Fighter,116.0,"Biography,Drama,Sport",7.8,316539,11000000,93617009,129262388,118262388,10.751126181818181
The Sessions,95.0,"Biography,Comedy,Drama",7.2,39731,1000000,6002451,11495204,10495204,10.495204
Q,103.0,Drama,5.6,5322,1200000,255000,255000,-945000,-0.7875
Carrie,100.0,"Drama,Horror",5.9,125424,30000000,35266619,82409520,52409520,1.746984
War Dogs,114.0,"Comedy,Crime,Drama",7.1,154029,50000000,43034523,86234503,36234503,0.72469006
American Sniper,133.0,"Action,Biography,Drama",7.3,401915,58000000,350126372,547326372,489326372,8.436661586206897
Jobs,128.0,"Biography,Drama",5.9,88788,18000000,16131410,43402515,25402515,1.4112508333333333
Locke,85.0,Drama,7.1,120703,2000000,1370646,2088390,88390,0.044195
Birth of the Dragon,95.0,"Action,Biography,Drama",5.4,6090,31000000,6901965,7220490,-23779510,-0.7670809677419355
Jonah Hex,81.0,"Action,Drama,Fantasy",4.7,51860,47000000,10547117,11022696,-35977304,-0.7654745531914894
The Roommate,91.0,"Drama,Thriller",4.9,33062,16000000,37300107,52545707,36545707,2.2841066875
Cyrus,91.0,"Comedy,Drama,Romance",6.3,32457,7000000,7468936,10062896,3062896,0.4375565714285714
Upside Down,109.0,"Drama,Fantasy,Romance",6.4,66347,50000000,102118,26387039,-23612961,-0.47225922
Your Sister's Sister,90.0,"Comedy,Drama",6.7,24780,120000,1597486,3090593,2970593,24.754941666666667
Anna Karenina,129.0,"Drama,Romance",6.6,84668,49000000,12816367,71004627,22004627,0.44907402040816324
Manchester by the Sea,137.0,Drama,7.8,214557,8500000,47695371,77733867,69233867,8.145160823529412
Darkest Hour,125.0,"Biography,Drama,History",7.4,136546,30000000,56443120,150807172,120807172,4.026905733333333
Moonlight,111.0,Drama,7.4,227964,1500000,27854931,65245512,63745512,42.497008
Creed II,130.0,"Drama,Sport",7.2,72503,50000000,115715889,213591522,163591522,3.27183044
Green Book,130.0,"Biography,Comedy,Drama",8.3,204972,23000000,85080171,322034439,299034439,13.001497347826087
The Ghost Writer,128.0,"Drama,Mystery,Thriller",7.2,148274,45000000,15541549,65532491,20532491,0.4562775777777778
Broken City,109.0,"Crime,Drama,Thriller",6.2,71704,35000000,19701164,34480045,-519955,-0.014855857142857143
The Last Song,107.0,"Drama,Music,Romance",6.0,74914,20000000,62950384,92678948,72678948,3.6339474
The Great Gatsby,143.0,"Drama,Romance",7.3,433165,190000000,144840419,351040419,161040419,0.847581152631579
Buried,95.0,"Drama,Mystery,Thriller",7.0,139426,1987650,1044143,21270290,19282640,9.701225064774986
Melancholia,135.0,"Drama,Sci-Fi",7.2,153434,9400000,3030848,21817298,12417298,1.3209891489361703
Everything Must Go,97.0,"Comedy,Drama",6.4,45799,5000000,2712131,2821010,-2178990,-0.435798
Only God Forgives,90.0,"Crime,Drama",5.7,100318,4800000,775849,4494560,-305440,-0.06363333333333333
Prom,104.0,"Comedy,Drama,Family",5.4,14279,8000000,10130219,10763183,2763183,0.345397875
Carnage,80.0,"Comedy,Drama",7.2,111372,25000000,2546747,38112154,13112154,0.52448616
Red Lights,114.0,"Drama,Fantasy,Horror",6.2,55287,17700000,49521,14518884,-3181116,-0.17972406779661018
Deepwater Horizon,107.0,"Action,Drama,History",7.1,133303,156000000,61433527,122603824,-33396176,-0.2140780512820513
After,105.0,"Drama,Romance",5.6,7699,650000,0,0,-650000,-1.0
Lights Out,81.0,"Drama,Horror,Mystery",6.3,100650,5000000,67268835,148806510,143806510,28.761302
Logan Lucky,118.0,"Comedy,Crime,Drama",7.0,105966,29000000,27778642,44264271,15264271,0.5263541724137931
The 15:17 to Paris,94.0,"Biography,Drama,Thriller",5.2,21880,30000000,36276286,56096200,26096200,0.8698733333333334
Welcome to the Rileys,110.0,Drama,7.0,22210,10000000,152857,355919,-9644081,-0.9644081
Downsizing,135.0,"Drama,Sci-Fi",5.7,74815,68000000,24449754,54462971,-13537029,-0.19907395588235294
Paranoia,106.0,"Drama,Thriller",5.7,33149,40000000,7388654,16340767,-23659233,-0.591480825
Haywire,93.0,"Action,Drama,Thriller",5.8,78681,23000000,18942396,36374700,13374700,0.5815086956521739
Le Havre,93.0,"Comedy,Drama",7.2,18490,5500000,611709,13480196,7980196,1.4509447272727272
127 Hours,94.0,"Adventure,Biography,Drama",7.6,323949,18000000,18335230,60217171,42217171,2.345398388888889
The Vow,104.0,"Drama,Romance",6.8,173629,30000000,125014030,197618160,167618160,5.587272
By the Sea,122.0,"Drama,Romance",5.3,16206,20000000,538460,3727746,-16272254,-0.8136127
Dope,103.0,"Comedy,Crime,Drama",7.2,76557,7000000,17506470,18190831,11190831,1.598690142857143
Bajrangi Bhaijaan,163.0,"Action,Comedy,Drama",8.0,63747,13000000,8178001,121778347,108778347,8.367565153846154
The Founder,115.0,"Biography,Drama,History",7.2,97841,15000000,12786053,24403192,9403192,0.6268794666666667
The Florida Project,111.0,Drama,7.6,72193,2000000,5904366,11295324,9295324,4.647662
Home Again,97.0,"Comedy,Drama,Romance",5.8,22614,15000000,27020284,37336874,22336874,1.4891249333333334
The Kids Are All Right,106.0,"Comedy,Drama,Romance",7.0,120656,4000000,20811365,36275469,32275469,8.06886725
San Andreas,114.0,"Action,Adventure,Drama",6.1,192750,110000000,155190832,456258539,346258539,3.1478049
The Fault in Our Stars,126.0,"Drama,Romance",7.7,315135,12000000,124872350,307166834,295166834,24.597236166666665
Fury,134.0,"Action,Drama,War",7.6,381993,80000000,85817906,210315681,130315681,1.6289460125
Obvious Child,84.0,"Comedy,Drama,Romance",6.8,21536,1000000,3122616,3324070,2324070,2.32407
Barbershop: The Next Cut,111.0,"Comedy,Drama",5.9,13306,20000000,54030051,54404202,34404202,1.7202101
Patti Cake$,109.0,"Drama,Music",6.7,8581,1000000,800148,1471090,471090,0.47109
Five Feet Apart,116.0,"Drama,Romance",7.2,10645,7000000,45729221,80504421,73504421,10.500631571428572
Please Give,87.0,"Comedy,Drama",6.6,10652,3000000,4033574,4570178,1570178,0.5233926666666666
Rabbit Hole,91.0,Drama,7.0,45357,5000000,2229058,6205034,1205034,0.2410068
The Railway Man,116.0,"Biography,Drama,Romance",7.1,34586,18000000,4438438,23910210,5910210,0.328345
Rocketman,121.0,"Biography,Drama,Music",7.7,24266,41000000,57342725,108642725,67642725,1.6498225609756099
Into the Storm,89.0,"Action,Adventure,Drama",5.8,60894,50000000,47602194,150429371,100429371,2.00858742
Yeh Jawaani Hai Deewani,160.0,"Comedy,Drama,Musical",7.1,33971,8300000,3827466,50827466,42527466,5.123791084337349
Transcendence,119.0,"Action,Drama,Sci-Fi",6.3,204481,100000000,23022309,103039258,3039258,0.03039258
Dear White People,108.0,"Comedy,Drama,Romance",6.1,23321,1250000,4404154,5403771,4153771,3.3230168
Dolphin Tale 2,107.0,"Drama,Family",6.4,7579,36000000,42024533,57824533,21824533,0.6062370277777778
Risen,107.0,"Action,Adventure,Drama",6.3,22813,20000000,36880033,46255763,26255763,1.31278815
Legend,132.0,"Biography,Crime,Drama",7.0,138947,25000000,15502112,23506237,-1493763,-0.05975052
My All-American,118.0,"Biography,Drama,Sport",7.2,5058,20000000,2246000,2246000,-17754000,-0.8877
Lion,118.0,"Biography,Drama",8.1,181601,12000000,51739495,149570720,137570720,11.464226666666667
The East,116.0,"Adventure,Drama,Thriller",6.8,46804,6500000,2274649,3027956,-3472044,-0.5341606153846153
Rush,123.0,"Action,Biography,Drama",8.1,393437,38000000,26947624,98230839,60230839,1.5850220789473684
The Finest Hours,117.0,"Action,Drama,History",6.8,55981,70000000,27569558,49252761,-20747239,-0.2963891285714286
The Final Girls,88.0,"Comedy,Drama,Fantasy",6.6,30219,4500000,0,0,-4500000,-1.0
St. Vincent,102.0,"Comedy,Drama",7.3,89372,13000000,44137712,54837234,41837234,3.2182487692307693
Wild,115.0,"Adventure,Biography,Drama",7.1,110138,15000000,37880356,52460543,37460543,2.4973695333333334
Endless Love,104.0,"Drama,Romance",6.3,37869,20000000,23438250,34718173,14718173,0.73590865
The Babadook,94.0,"Drama,Horror",6.8,171411,2000000,950792,7482387,5482387,2.7411935
Unfinished Business,91.0,"Comedy,Drama",5.4,29004,35000000,10219501,13214051,-21785949,-0.6224556857142857
Lost River,95.0,"Drama,Fantasy,Mystery",5.8,15667,2000000,45431,2009644,9644,0.004822
Carol,118.0,"Drama,Romance",7.2,100680,11800000,12711491,42843521,31043521,2.6308068644067797
Black or White,121.0,Drama,6.6,10659,9000000,21571189,21971021,12971021,1.4412245555555556
Mommy,139.0,Drama,8.1,43020,4900000,3498695,17536004,12636004,2.5787763265306123
The Girl on the Train,112.0,"Crime,Drama,Mystery",6.5,150977,45000000,75395035,174278214,129278214,2.8728492
Swiss Army Man,97.0,"Adventure,Comedy,Drama",7.0,91736,3000000,4210454,5837111,2837111,0.9457036666666667
Collateral Beauty,97.0,"Drama,Romance",6.8,78764,36000000,31016021,85309093,49309093,1.3696970277777778
The Shape of Water,123.0,"Adventure,Drama,Fantasy",7.3,308112,19500000,63859435,195790794,176290794,9.040553538461538
Proud Mary,89.0,"Action,Crime,Drama",4.9,6805,30000000,20868638,21709539,-8290461,-0.2763487
Serenity,106.0,"Drama,Mystery,Sci-Fi",5.3,17904,39000000,25514517,40319440,1319440,0.03383179487179487
"Hail, Caesar!",106.0,"Comedy,Drama,Music",6.3,111422,22000000,30080225,64160680,42160680,1.9163945454545455
Eddie the Eagle,106.0,"Biography,Comedy,Drama",7.4,75331,23000000,15789389,45060480,22060480,0.9591513043478261
Free State of Jones,139.0,"Action,Biography,Drama",6.9,45135,50000000,20810036,23237252,-26762748,-0.53525496
The Debt,113.0,"Drama,Thriller",6.9,61046,20000000,31177548,46604054,26604054,1.3302027
Easy A,92.0,"Comedy,Drama,Romance",7.1,330125,8000000,58401464,76200721,68200721,8.525090125
The Last Exorcism,87.0,"Drama,Horror,Thriller",5.6,45815,1800000,41034350,70165900,68365900,37.98105555555556
Courageous,129.0,Drama,7.0,17586,2000000,34522221,35185884,33185884,16.592942
Deadfall,95.0,"Crime,Drama,Thriller",6.3,36491,6000000,66351,1673635,-4326365,-0.7210608333333334
Snowpiercer,126.0,"Action,Drama,Sci-Fi",7.1,239264,40000000,4563029,88069880,48069880,1.201747
Before I Go to Sleep,92.0,"Drama,Horror,Mystery",6.3,64684,22000000,3242457,19563579,-2436421,-0.11074640909090909
The Tree of Life,139.0,"Drama,Fantasy",6.8,156266,35000000,13305665,61721826,26721826,0.7634807428571428
Tulip Fever,105.0,"Drama,History,Romance",6.2,15037,25000000,2455635,6792768,-18207232,-0.72828928
Death Wish,107.0,"Action,Crime,Drama",6.4,50279,30000000,34017028,48575965,18575965,0.6191988333333334
First Man,141.0,"Biography,Drama,History",7.4,120009,60000000,44936545,105203825,45203825,0.7533970833333333
47 Ronin,128.0,"Action,Adventure,Drama",6.3,135754,175000000,38362475,151716815,-23283185,-0.13304677142857144
Bait,93.0,"Action,Adventure,Drama",5.2,14627,35000000,15325127,15471969,-19528031,-0.5579437428571429
The American,105.0,"Crime,Drama,Thriller",6.3,86863,20000000,35606376,67950723,47950723,2.39753615
Martha Marcy May Marlene,102.0,"Drama,Mystery,Thriller",6.9,45873,1000000,2981038,5438911,4438911,4.438911
The Next Three Days,133.0,"Action,Crime,Drama",7.4,168066,30000000,21148651,67255916,37255916,1.2418638666666666
Jackie,100.0,"Biography,Drama,History",6.7,66008,9000000,13960394,36588512,27588512,3.0653902222222222
Miss Sloane,132.0,"Drama,Thriller",7.5,52788,18000000,3500605,7719630,-10280370,-0.5711316666666667
The Hate U Give,133.0,"Crime,Drama",7.3,17583,23000000,29719483,35067665,12067665,0.5246810869565217
Real Steel,127.0,"Action,Drama,Family",7.1,283534,110000000,85463309,263880341,153880341,1.398912190909091
Hugo,126.0,"Adventure,Drama,Family",7.5,284869,180000000,73864507,180047784,47784,0.00026546666666666665
Child 44,137.0,"Crime,Drama,History",6.5,59477,50000000,1224330,8004221,-41995779,-0.83991558
The Lost City of Z,141.0,"Adventure,Biography,Drama",6.6,66475,30000000,8574339,17121823,-12878177,-0.4292725666666667
Womb,111.0,"Drama,Romance,Sci-Fi",6.4,12489,13000000,0,0,-13000000,-1.0
Frozen,93.0,"Adventure,Drama,Sport",6.2,62311,150000000,400738009,1272469910,1122469910,7.483132733333333
Straight Outta Compton,147.0,"Biography,Drama,History",7.9,165307,28000000,161197785,202182981,174182981,6.22082075
The Iceman,106.0,"Biography,Crime,Drama",6.9,65571,10000000,1930282,3623609,-6376391,-0.6376391
"Jeff, Who Lives at Home",83.0,"Comedy,Drama",6.5,60070,10000000,4269426,4708127,-5291873,-0.5291873
The Perks of Being a Wallflower,103.0,Drama,8.0,422671,13000000,17742948,33069303,20069303,1.5437925384615385
The Calling,108.0,"Drama,Thriller",5.8,7350,2500000,0,0,-2500000,-1.0
Eden,98.0,"Crime,Drama",6.7,7709,2300000,0,0,-2300000,-1.0
Like Crazy,86.0,"Drama,Romance",6.7,55841,250000,3395391,3728400,3478400,13.9136
Like Crazy,116.0,"Comedy,Drama",7.2,7156,250000,3395391,3728400,3478400,13.9136
Step Up Revolution,99.0,"Drama,Music,Romance",6.5,51295,33000000,35074677,165552290,132552290,4.0167360606060605
Admission,107.0,"Comedy,Drama,Romance",5.7,31849,13000000,18007317,18733666,5733666,0.44105123076923075
The Lady in the Van,104.0,"Biography,Comedy,Drama",6.7,23105,6000000,10021175,42320503,36320503,6.053417166666667
The Space Between Us,120.0,"Adventure,Drama,Romance",6.4,41031,30000000,7885294,16481405,-13518595,-0.45061983333333333
Dheepan,115.0,"Crime,Drama",7.2,12312,9000000,248795,7704357,-1295643,-0.14396033333333333
The Wall,88.0,"Action,Drama,Thriller",6.2,20391,3000000,1803064,4495262,1495262,0.4984206666666667
The Wall,108.0,"Drama,Fantasy,Mystery",6.8,5484,3000000,1803064,4495262,1495262,0.4984206666666667
"Three Billboards Outside Ebbing, Missouri",115.0,"Crime,Drama",8.2,344047,12000000,54513740,160191915,148191915,12.34932625
The Post,116.0,"Biography,Drama,History",7.2,108017,50000000,81903458,179748880,129748880,2.5949776
Robot & Frank,89.0,"Comedy,Crime,Drama",7.1,59229,2500000,3317468,4934356,2434356,0.9737424
No Good Deed,84.0,"Action,Crime,Drama",5.6,16045,13200000,52543632,54323210,41123210,3.115394696969697
Fruitvale Station,85.0,"Biography,Drama,Romance",7.5,68187,900000,16098998,17549645,16649645,18.499605555555554
Joy,124.0,Drama,6.6,118086,60000000,56451232,101134059,41134059,0.68556765
Wish I Was Here,106.0,"Comedy,Drama",6.7,34907,6000000,3591299,6591365,591365,0.09856083333333333
Life,111.0,"Biography,Drama",6.1,6604,75000000,64062587,73521587,-1478413,-0.019712173333333333
The Hundred-Foot Journey,122.0,"Comedy,Drama",7.3,69562,22000000,54235441,94270488,72270488,3.285022181818182
Sully,96.0,"Biography,Drama",7.5,202718,60000000,125070033,238524556,178524556,2.9754092666666665
Sicario,121.0,"Action,Crime,Drama",7.6,328548,30000000,46889293,84393749,54393749,1.8131249666666667
Unforgettable,100.0,"Drama,Thriller",5.1,11489,18000000,2483790,2483790,-15516210,-0.8620116666666666
Glass,129.0,"Drama,Sci-Fi,Thriller",6.8,133793,20000000,111035005,245303505,225303505,11.26517525
A Simple Favor,117.0,"Comedy,Crime,Drama",6.9,83338,20000000,53548586,97628717,77628717,3.88143585
Hereditary,127.0,"Drama,Horror,Mystery",7.3,151571,10000000,44069456,70133905,60133905,6.0133905
Lawless,116.0,"Crime,Drama",7.3,214055,26000000,37397291,54393687,28393687,1.0920648846153846
Animal Kingdom,113.0,"Crime,Drama",7.3,51576,4200000,1044039,8078683,3878683,0.9234959523809524
Made in Dagenham,113.0,"Biography,Comedy,Drama",7.2,13121,8000000,1095369,15644196,7644196,0.9555245
Dream House,84.0,"Drama,Mystery,Thriller",6.0,59714,50000000,21302340,41642166,-8357834,-0.16715668
The Master,138.0,Drama,7.1,131365,37500000,16247159,50647416,13147416,0.35059776
The Woman in Black,95.0,"Drama,Fantasy,Horror",6.4,165357,15000000,54333290,128955898,113955898,7.597059866666667
Contagion,106.0,"Action,Drama,Thriller",6.6,201536,60000000,75658097,137551594,77551594,1.2925265666666668
J. Edgar,137.0,"Biography,Crime,Drama",6.6,115925,35000000,37306030,84606030,49606030,1.4173151428571429
Safe Haven,115.0,"Drama,Romance,Thriller",6.7,97055,28000000,71399120,94050951,66050951,2.358962535714286
Snow White and the Huntsman,127.0,"Action,Adventure,Drama",6.1,258938,170000000,155136755,401021746,231021746,1.3589514470588235
While We're Young,97.0,"Comedy,Drama,Mystery",6.3,41327,10000000,7582065,17503828,7503828,0.7503828
Queen of the Desert,128.0,"Adventure,Biography,Drama",5.7,8529,36000000,0,1578543,-34421457,-0.9561515833333334
Mud,130.0,Drama,7.4,156786,10000000,21590086,31556959,21556959,2.1556959
Victor Frankenstein,110.0,"Drama,Horror,Sci-Fi",6.0,47492,40000000,5775076,31124367,-8875633,-0.221890825
12 Years a Slave,134.0,"Biography,Drama,History",8.1,577301,20000000,56671993,181025343,161025343,8.05126715
The Monuments Men,118.0,"Comedy,Drama,History",6.1,117638,70000000,78031620,158702748,88702748,1.2671821142857143
The Gunman,115.0,"Action,Crime,Drama",5.8,36053,40000000,10664749,18594227,-21405773,-0.535144325
Birdman or (The Unexpected Virtue of Ignorance),119.0,"Comedy,Drama",7.7,519417,18000000,42340598,103215094,85215094,4.734171888888889
Fences,139.0,Drama,7.2,86749,24000000,57682904,64282881,40282881,1.678453375
Churchill,105.0,"Biography,Drama,History",6.3,12047,10000000,1279681,7582196,-2417804,-0.2417804
Zipper,112.0,"Drama,Thriller",5.8,6120,4500000,0,0,-4500000,-1.0
Red Tails,125.0,"Action,Adventure,Drama",5.9,31815,58000000,49876377,50365498,-7634502,-0.1316293448275862
Something Borrowed,112.0,"Comedy,Drama,Romance",5.9,54314,35000000,39046489,65084116,30084116,0.8595461714285715
It's Kind of a Funny Story,101.0,"Comedy,Drama,Romance",7.1,125583,8000000,6363628,6632950,-1367050,-0.17088125
Take Me Home Tonight,97.0,"Comedy,Drama,Romance",6.3,48393,19000000,6928068,7576604,-11423396,-0.6012313684210526
The Killer Inside Me,109.0,"Crime,Drama,Horror",6.1,31727,13000000,217277,3617277,-9382723,-0.721747923076923
Safety Not Guaranteed,86.0,"Comedy,Drama,Romance",7.0,111907,750000,4010957,4422318,3672318,4.896424
Side Effects,106.0,"Crime,Drama,Mystery",7.1,168466,30000000,32172757,66742138,36742138,1.2247379333333333
Delivery Man,105.0,"Comedy,Drama",6.4,70706,22000000,30659817,70536870,48536870,2.2062213636363635
Philomena,98.0,"Biography,Comedy,Drama",7.6,88704,12000000,37709979,98963392,86963392,7.246949333333333
Red Sparrow,140.0,"Action,Drama,Thriller",6.6,136738,69000000,46874505,145951861,76951861,1.1152443623188406
American Heist,94.0,"Action,Crime,Drama",5.1,15547,10000000,0,2341218,-7658782,-0.7658782
Cargo,105.0,"Drama,Horror,Sci-Fi",6.3,27339,4200000,0,313230,-3886770,-0.9254214285714286
Patriots Day,133.0,"Action,Crime,Drama",7.4,76204,40000000,31886361,52837989,12837989,0.320949725
Ravenous,104.0,"Drama,Horror,Sci-Fi",5.9,5970,12000000,2062406,2062406,-9937594,-0.8281328333333333
The Iron Lady,105.0,"Biography,Drama",6.4,96066,14000000,29959436,115592104,101592104,7.256578857142857
Snowden,134.0,"Biography,Drama,Thriller",7.3,119149,50000000,21587519,35380918,-14619082,-0.29238164
Evolution,81.0,"Drama,Mystery,Sci-Fi",6.0,5266,80000000,38311134,98341932,18341932,0.22927415
Hotel Artemis,94.0,"Action,Drama,Sci-Fi",6.1,30586,15000000,6708137,12758799,-2241201,-0.1494134
Fifty Shades Darker,118.0,"Drama,Romance",4.6,81706,55000000,114434010,381398492,326398492,5.934518036363636
Trapped,105.0,"Action,Drama,Thriller",7.6,7683,30000000,6916869,6916869,-23083131,-0.7694377
Interstellar,169.0,"Adventure,Drama,Sci-Fi",8.6,1299334,165000000,188017894,666379375,501379375,3.038662878787879
Green Zone,115.0,"Action,Drama,Thriller",6.8,122132,100000000,35497337,97523020,-2476980,-0.0247698
Looper,113.0,"Action,Crime,Drama",7.4,500595,30000000,66486205,170466405,140466405,4.6822135
The Reef,94.0,"Adventure,Drama,Horror",5.8,15194,10000000,0,15037867,5037867,0.5037867
Tinker Tailor Soldier Spy,122.0,"Drama,Mystery,Thriller",7.1,174890,21000000,24149393,81452811,60452811,2.8787052857142856
Cloud Atlas,172.0,"Action,Drama,Mystery",7.4,326473,102000000,27108272,130673154,28673154,0.28110935294117645
Why Did I Get Married Too?,121.0,"Comedy,Drama,Romance",4.6,8653,20000000,60095852,60831067,40831067,2.04155335
The Greatest Showman,105.0,"Biography,Drama,Musical",7.6,199663,84000000,174340174,386665550,302665550,3.6031613095238093
Absentia,87.0,"Drama,Horror,Mystery",5.8,15507,70000,0,8555,-61445,-0.8777857142857143
Take Shelter,121.0,"Drama,Horror,Thriller",7.4,83200,4750000,1728953,4972016,222016,0.04674021052631579
The Guilt Trip,95.0,"Comedy,Drama",5.8,33702,40000000,37134215,41294674,1294674,0.03236685
Weekend,97.0,"Drama,Romance",7.6,25424,190000,484592,1577585,1387585,7.303078947368421
Secret in Their Eyes,111.0,"Crime,Drama,Mystery",6.3,37455,20000000,20180155,32608019,12608019,0.63040095
Her,126.0,"Drama,Romance,Sci-Fi",8.0,467232,23000000,25568251,48163815,25163815,1.0940789130434783
Little Boy,106.0,"Drama,History,War",7.4,20945,20000000,6485961,17769299,-2230701,-0.11153505
Destroyer,121.0,"Action,Crime,Drama",6.2,13683,9000000,1533324,3681096,-5318904,-0.5909893333333334
The Best Man Holiday,123.0,"Comedy,Drama",6.7,13967,17000000,70525195,72835710,55835710,3.2844535294117647
Into the Woods,125.0,"Adventure,Comedy,Drama",6.0,123577,56200000,128002372,213116401,156916401,2.7921067793594307
Before Midnight,109.0,"Drama,Romance",7.9,123107,3000000,8110621,23251930,20251930,6.7506433333333336
Rosewater,103.0,"Biography,Drama",6.6,9836,10000000,3128941,3185717,-6814283,-0.6814283
Whiskey Tango Foxtrot,112.0,"Biography,Comedy,Drama",6.6,46265,35000000,23083334,25350747,-9649253,-0.27569294285714285
La La Land,128.0,"Comedy,Drama,Music",8.0,436070,20000000,151101803,426351163,406351163,20.31755815
War Room,120.0,Drama,6.5,11716,3000000,67790117,73975239,70975239,23.658413
"Everything, Everything",96.0,"Drama,Romance",6.4,26811,10000000,34121140,61603136,51603136,5.1603136
Acrimony,120.0,"Drama,Romance,Thriller",5.7,6119,20000000,43549096,46627836,26627836,1.3313918
"Paul, Apostle of Christ",108.0,"Adventure,Biography,Drama",6.7,5662,5000000,17547999,25529498,20529498,4.1058996
The Ides of March,101.0,"Drama,Thriller",7.1,207417,23000000,40962534,77735925,54735925,2.3798228260869565
Big Eyes,106.0,"Biography,Crime,Drama",7.0,77447,10000000,14482031,27317872,17317872,1.7317872
Beastly,86.0,"Drama,Fantasy,Romance",5.6,72599,17000000,27865571,38028230,21028230,1.236954705882353
Jack Ryan: Shadow Recruit,105.0,"Action,Drama,Thriller",6.2,114913,60000000,50577412,131377412,71377412,1.1896235333333334
August: Osage County,121.0,"Comedy,Drama",7.2,79383,25000000,37738810,50738810,25738810,1.0295524
Black Mass,123.0,"Biography,Crime,Drama",6.9,155847,53000000,62575678,98837872,45837872,0.8648655094339622
Beneath Hill 60,122.0,"Drama,History,War",7.1,6903,9000000,0,3440939,-5559061,-0.6176734444444445
The Odd Life of Timothy Green,105.0,"Comedy,Drama,Family",6.6,42770,40000000,51853450,55249159,15249159,0.381228975
A Better Life,98.0,"Drama,Romance",7.2,14602,10000000,1759252,1884251,-8115749,-0.8115749
Savages,131.0,"Crime,Drama,Thriller",6.5,115793,45000000,47323100,82513490,37513490,0.8336331111111112
Sound of My Voice,85.0,"Drama,Mystery,Sci-Fi",6.6,19387,135000,408015,429448,294448,2.181096296296296
The Snowman,119.0,"Crime,Drama,Mystery",5.1,47890,35000000,6670765,43226146,8226146,0.23503274285714285
The Darkest Minds,104.0,"Action,Adventure,Drama",5.7,21340,34000000,12695691,38361428,4361428,0.12827729411764707
The Circle,110.0,"Drama,Sci-Fi,Thriller",5.3,72536,18000000,20497844,40651864,22651864,1.2584368888888888
Chocolat,119.0,"Biography,Drama",7.0,5772,25000000,71309760,152500343,127500343,5.10001372
Lady Bird,94.0,"Comedy,Drama",7.4,177677,10000000,48958273,78610769,68610769,6.8610769
"Roman J. Israel, Esq.",122.0,"Crime,Drama,Thriller",6.4,23632,22000000,11962712,12967012,-9032988,-0.41059036363636364
I Can Only Imagine,110.0,"Biography,Drama,Family",7.4,11439,7000000,83482352,85604221,78604221,11.22917442857143
On the Road,124.0,"Adventure,Drama,Romance",6.1,37886,25000000,720828,9313302,-15686698,-0.62746792
Spotlight,129.0,"Crime,Drama",8.1,365110,20000000,45055776,92088460,72088460,3.604423
Father Figures,113.0,"Adventure,Comedy,Drama",5.5,14373,25000000,17501244,21038441,-3961559,-0.15846236
Dead Man Down,118.0,"Action,Crime,Drama",6.5,61238,30000000,10895295,19599974,-10400026,-0.34666753333333333
Addicted,106.0,"Drama,Thriller",5.2,7640,5000000,17390770,17499242,12499242,2.4998484
White House Down,131.0,"Action,Drama,Thriller",6.4,191791,150000000,73103784,205440387,55440387,0.36960258
Live by Night,129.0,"Action,Crime,Drama",6.4,47243,65000000,10378555,21774432,-43225568,-0.6650087384615384
The Last Five Years,94.0,"Comedy,Drama,Musical",5.9,8735,2000000,147299,205298,-1794702,-0.897351
Me Before You,106.0,"Drama,Romance",7.4,174567,20000000,56245075,208265198,188265198,9.4132599
Happy Christmas,82.0,"Comedy,Drama",5.5,7217,70000,30312,30312,-39688,-0.5669714285714286
Tusk,102.0,"Comedy,Drama,Horror",5.3,40827,3000000,1821983,1887554,-1112446,-0.37081533333333333
Vice,132.0,"Biography,Comedy,Drama",7.2,72855,60000000,47836282,70883171,10883171,0.18138618333333334
The Martian,144.0,"Adventure,Drama,Sci-Fi",8.0,680116,108000000,228433663,655271443,547271443,5.067328175925926
Eighth Grade,93.0,"Comedy,Drama",7.5,43256,2000000,13539710,14341016,12341016,6.170508
The Wolfman,103.0,"Drama,Fantasy,Horror",5.8,97873,150000000,62189884,142634358,-7365642,-0.04910428
The Man Who Knew Infinity,108.0,"Biography,Drama",7.2,43575,10000000,3877922,12382122,2382122,0.2382122
Centurion,97.0,"Action,Adventure,Drama",6.4,74085,15000000,123570,7885048,-7114952,-0.47433013333333335
Silver Linings Playbook,122.0,"Comedy,Drama,Romance",7.7,621018,21000000,132092958,236412453,215412453,10.257735857142857
Labor Day,111.0,"Drama,Romance",6.9,39242,18000000,13371528,14189810,-3810190,-0.2116772222222222
The Last Exorcism Part II,88.0,"Drama,Horror,Thriller",4.0,15124,4000000,15179303,25448707,21448707,5.36217675
Second Act,103.0,"Comedy,Drama,Romance",5.8,13109,15700000,39282227,63288854,47588854,3.0311371974522294
Focus,105.0,"Comedy,Crime,Drama",6.6,192147,65000000,53862963,168065700,103065700,1.5856261538461538
Joe,117.0,"Crime,Drama",6.9,42825,4000000,373375,373375,-3626625,-0.90665625
Get on Up,139.0,"Biography,Drama,Music",6.9,19024,30000000,30569935,33339868,3339868,0.11132893333333334
The Walk,123.0,"Adventure,Biography,Drama",7.3,109714,35000000,10161183,61492104,26492104,0.7569172571428572
Girls Trip,122.0,"Comedy,Drama",6.2,29321,28000000,115108515,140886353,112886353,4.0316554642857145
A Street Cat Named Bob,103.0,"Biography,Comedy,Drama",7.4,23204,8000000,82703,17382693,9382693,1.172836625
Forever My Girl,108.0,"Drama,Music,Romance",6.7,10316,3500000,16376066,16376066,12876066,3.678876
Hunt for the Wilderpeople,101.0,"Adventure,Comedy,Drama",7.9,87532,2500000,5205471,23845533,21345533,8.5382132
How to Be a Latin Lover,115.0,"Comedy,Drama",5.9,11747,10000000,32149404,62556228,52556228,5.2556228
A Ghost Story,92.0,"Drama,Fantasy,Romance",6.8,46280,100000,1594798,2769782,2669782,26.69782
Silence,161.0,"Adventure,Drama,History",7.2,85242,46500000,7100177,23726626,-22773374,-0.48974997849462365
Kill the Messenger,112.0,"Biography,Crime,Drama",7.0,41231,5000000,2450846,6656705,1656705,0.331341
Seeking a Friend for the End of the World,101.0,"Adventure,Comedy,Drama",6.7,102047,10000000,7078738,11766959,1766959,0.1766959
The Infiltrator,127.0,"Biography,Crime,Drama",7.0,61547,47500000,15436808,20718104,-26781896,-0.5638293894736842
Winter's Bone,100.0,"Drama,Mystery",7.2,127751,2000000,6531503,16131551,14131551,7.0657755
Kidnap,95.0,"Crime,Drama,Thriller",5.9,28898,21000000,30718107,34836080,13836080,0.6588609523809524
The Giant Mechanical Man,95.0,"Comedy,Drama,Romance",6.7,8921,900000,7396,7396,-892604,-0.9917822222222222
Redemption,100.0,"Action,Crime,Drama",6.2,61317,23000000,36686,13593473,-9406527,-0.4089794347826087
3 Days to Kill,117.0,"Action,Drama,Thriller",6.2,81681,28000000,30697999,38959900,10959900,0.391425
Zulu,110.0,"Crime,Drama,Thriller",6.7,16607,16000000,0,1844228,-14155772,-0.88473575
Arrival,116.0,"Drama,Mystery,Sci-Fi",7.9,515483,47000000,100546139,203127894,156127894,3.321870085106383
Whiplash,106.0,"Drama,Music",8.5,616916,3300000,13092006,38969037,35669037,10.80879909090909
Veronica Mars,107.0,"Crime,Drama,Mystery",6.8,46751,6000000,3322127,3485383,-2514617,-0.4191028333333333
Nocturnal Animals,116.0,"Drama,Thriller",7.5,205240,22500000,10663357,32398681,9898681,0.43994137777777775
"Love, Simon",110.0,"Comedy,Drama,Romance",7.6,81575,10000000,40826341,65520633,55520633,5.5520633
The Big Sick,120.0,"Comedy,Drama,Romance",7.6,104008,5000000,42872467,53972860,48972860,9.794572
Thoroughbreds,92.0,"Comedy,Crime,Drama",6.7,25098,5000000,3072605,3187302,-1812698,-0.3625396
First Reformed,113.0,"Drama,Mystery,Thriller",7.1,33542,3500000,3448256,3874772,374772,0.10707771428571429
The Legend of Tarzan,110.0,"Action,Adventure,Drama",6.3,150154,180000000,126643061,348902025,168902025,0.9383445833333334
The Eagle,114.0,"Action,Adventure,Drama",6.2,61475,25000000,19490041,38993548,13993548,0.55974192
Do You Believe?,120.0,Drama,6.1,6462,2300000,12985600,14304931,12004931,5.2195352173913045
Wish Upon,90.0,"Drama,Fantasy,Horror",5.0,14962,12000000,14301505,23477345,11477345,0.9564454166666667
The Illusionist,80.0,"Animation,Drama",7.5,31734,16500000,39868642,83792062,67292062,4.0783067878787875
Selma,128.0,"Biography,Drama,History",7.5,77633,20000000,52076908,66776576,46776576,2.3388288
The Edge of Seventeen,104.0,"Comedy,Drama",7.3,87602,9000000,14431633,19096003,10096003,1.1217781111111111
Pompeii,105.0,"Action,Adventure,Drama",5.5,100467,80000000,23169033,108469033,28469033,0.3558629125
The Immigrant,120.0,"Drama,Romance",6.6,26618,16000000,2013456,7585011,-8414989,-0.5259368125
King Arthur: Legend of the Sword,126.0,"Action,Adventure,Drama",6.8,169054,175000000,39175066,139630336,-35369664,-0.2021123657142857
Steve Jobs,122.0,"Biography,Drama",7.2,138668,30000000,17766658,35579007,5579007,0.1859669
Promised Land,106.0,Drama,6.6,34659,15000000,7597898,12394562,-2605438,-0.17369586666666667
Gone Girl,149.0,"Drama,Mystery,Thriller",8.1,761592,61000000,167767189,368567189,307567189,5.042085065573771
Brooklyn,117.0,"Drama,Romance",7.5,117021,11000000,38322743,62076141,51076141,4.643285545454545
Project Almanac,106.0,"Drama,Mystery,Sci-Fi",6.4,71500,12000000,22348241,32909437,20909437,1.7424530833333334
The Water Diviner,111.0,"Drama,History,War",7.1,66595,22500000,4200117,31054727,8554727,0.3802100888888889
Welcome to Marwen,116.0,"Biography,Comedy,Drama",6.1,8920,45000000,10763520,12874922,-32125078,-0.7138906222222222
Book Club,104.0,"Comedy,Drama,Romance",6.1,18728,10000000,68566296,91113683,81113683,8.1113683
Secretariat,123.0,"Biography,Drama,Family",7.2,24536,35000000,59699513,60376247,25376247,0.7250356285714286
Lone Survivor,121.0,"Action,Biography,Drama",7.5,246641,40000000,125095601,149804632,109804632,2.7451158
The Lincoln Lawyer,118.0,"Crime,Drama,Thriller",7.3,196109,40000000,58009200,87145086,47145086,1.17862715
Warrior,140.0,"Drama,Sport",8.2,403755,25000000,13657115,24215385,-784615,-0.0313846
In Time,109.0,"Action,Crime,Drama",6.7,346077,35000000,37553932,165103952,130103952,3.7172557714285714
Silent House,86.0,"Drama,Horror,Mystery",5.3,20831,2000000,12739737,16610760,14610760,7.30538
End of Watch,109.0,"Action,Crime,Drama",7.6,211308,15000000,41003371,57586606,42586606,2.8391070666666667
Sparkle,116.0,"Drama,Music",5.7,5643,10000000,24397469,24660323,14660323,1.4660323
Phantom,98.0,"Drama,History,Thriller",5.9,12786,18000000,1034589,1199510,-16800490,-0.9333605555555555
Phantom,136.0,"Action,Drama,Thriller",5.8,7739,18000000,1034589,1199510,-16800490,-0.9333605555555555
Eye in the Sky,102.0,"Drama,Thriller,War",7.3,72301,13000000,18704596,35402802,22402802,1.7232924615384615
Woman in Gold,109.0,"Biography,Drama,History",7.3,48501,11000000,33307793,58586407,47586407,4.326037
Beauty and the Beast,112.0,"Drama,Fantasy,Romance",6.4,18100,160000000,504014165,1259199706,1099199706,6.8699981625
The Signal,97.0,"Drama,Mystery,Sci-Fi",6.1,58407,4000000,600896,2665322,-1334678,-0.3336695
Camp X-Ray,117.0,"Drama,War",6.9,36700,1000000,9837,101053,-898947,-0.898947
Not Cool,93.0,"Comedy,Drama,Romance",4.5,5089,800000,35688,35688,-764312,-0.95539
Breaking In,88.0,"Action,Crime,Drama",5.4,10154,6000000,46840590,51411620,45411620,7.568603333333333
The Town,125.0,"Crime,Drama,Thriller",7.6,322524,37000000,92186262,152566881,115566881,3.1234292162162163
Hanna,111.0,"Action,Drama,Thriller",6.8,179178,30000000,40259119,65343694,35343694,1.1781231333333333
Beautiful Boy,120.0,"Biography,Drama",7.3,30368,25000000,7634767,13031424,-11968576,-0.47874304
Beautiful Boy,100.0,Drama,6.6,6058,25000000,7634767,13031424,-11968576,-0.47874304
The Tempest,110.0,"Comedy,Drama,Fantasy",5.4,7073,20000000,277943,277943,-19722057,-0.98610285
Meek's Cutoff,104.0,"Drama,Western",6.6,10439,2000000,977772,1869928,-130072,-0.065036
Young Adult,94.0,"Comedy,Drama",6.3,74071,12000000,16311571,22750356,10750356,0.895863
Colombiana,108.0,"Action,Drama,Thriller",6.4,87659,40000000,36665854,72295262,32295262,0.80738155
Zero Dark Thirty,157.0,"Drama,Thriller",7.4,251072,52500000,95720716,134612435,82112435,1.564046380952381
Django Unchained,165.0,"Drama,Western",8.4,1211405,100000000,162805434,449948323,349948323,3.49948323
Won't Back Down,121.0,Drama,6.4,5915,19000000,5310554,5745503,-13254497,-0.6976051052631579
The Judge,141.0,"Crime,Drama",7.4,162952,50000000,47119388,76119388,26119388,0.52238776
A Most Wanted Man,122.0,"Crime,Drama,Thriller",6.8,67914,15000000,17237855,36068890,21068890,1.4045926666666666
Mr. Turner,150.0,"Biography,Drama,History",6.8,22661,14000000,3958546,25187026,11187026,0.7990732857142857
Murder on the Orient Express,114.0,"Crime,Drama,Mystery",6.5,178603,55000000,102826543,345922730,290922730,5.289504181818182
BlacKkKlansman,135.0,"Biography,Crime,Drama",7.5,149005,15000000,49275340,93017335,78017335,5.201155666666667
The Book Thief,131.0,"Drama,War",7.6,119023,19000000,21488481,76086711,57086711,3.004563736842105
The Wolf of Wall Street,180.0,"Biography,Crime,Drama",8.2,1035358,100000000,116900694,389870414,289870414,2.89870414
Magic Mike,110.0,"Comedy,Drama",6.1,123955,7000000,113721571,170549753,163549753,23.364250428571427
Compliance,90.0,"Biography,Crime,Drama",6.4,28703,270000,319285,830700,560700,2.0766666666666667
Inside Llewyn Davis,104.0,"Drama,Music",7.5,123759,11000000,13248209,32943247,21943247,1.9948406363636364
Fifty Shades of Grey,125.0,"Drama,Romance,Thriller",4.1,279126,40000000,166167230,570998101,530998101,13.274952525
Strangerland,112.0,"Drama,Mystery,Thriller",5.2,7999,10000000,17472,161097,-9838903,-0.9838903
Parkland,93.0,"Drama,History,Mystery",6.4,14036,10000000,641439,1616353,-8383647,-0.8383647
Frontera,103.0,"Drama,Thriller,Western",6.6,6861,2300000,59696,59696,-2240304,-0.9740452173913043
Ida,82.0,Drama,7.4,46819,2600000,3827060,15298355,12698355,4.8839826923076926
Bird Box,124.0,"Drama,Horror,Sci-Fi",6.6,218063,19800000,0,0,-19800000,-1.0
Ex Machina,108.0,"Drama,Mystery,Sci-Fi",7.7,424542,13000000,25440971,38358392,25358392,1.9506455384615384
Burlesque,119.0,"Drama,Music,Musical",6.4,71021,55000000,39440655,90552675,35552675,0.6464122727272728
Step Up 3D,107.0,"Drama,Music,Romance",6.2,53081,30000000,42400223,165889117,135889117,4.529637233333333
Ironclad,121.0,"Action,Adventure,Drama",6.2,38477,25000000,0,5297411,-19702589,-0.78810356
Extraordinary Measures,106.0,Drama,6.5,15673,31000000,12482741,15826984,-15173016,-0.48945212903225804
Gangster Squad,113.0,"Action,Crime,Drama",6.7,195560,60000000,46000903,104100903,44100903,0.73501505
Beginners,105.0,"Comedy,Drama,Romance",7.2,83770,3200000,5790894,14314407,11114407,3.4732521875
The Innkeepers,101.0,"Drama,Horror,Mystery",5.5,31089,750000,78396,1011535,261535,0.3487133333333333
The Sapphires,103.0,"Biography,Comedy,Drama",7.0,12143,9000000,2450867,20395040,11395040,1.2661155555555557
Before I Fall,98.0,"Drama,Fantasy,Mystery",6.4,39282,5000000,12241072,18945682,13945682,2.7891364
Into the Grizzly Maze,94.0,"Action,Adventure,Drama",5.3,7006,10000000,0,0,-10000000,-1.0
The Words,102.0,"Drama,Mystery,Romance",7.1,70308,6000000,11494838,16369708,10369708,1.7282846666666667
The 33,127.0,"Biography,Drama,History",6.9,32263,25000000,12227722,28400715,3400715,0.1360286
Saving Mr. Banks,125.0,"Biography,Comedy,Drama",7.5,140678,35000000,83299761,114962525,79962525,2.2846435714285716
The Disappointments Room,85.0,"Drama,Horror,Thriller",3.9,8167,15000000,2423467,3503761,-11496239,-0.7664159333333334
Enough Said,93.0,"Comedy,Drama,Romance",7.0,55698,8000000,17550872,25621449,17621449,2.202681125
Shut In,91.0,"Drama,Mystery,Thriller",4.7,11030,10000000,6900335,11360665,1360665,0.1360665
Room,118.0,"Drama,Thriller",8.2,316791,13000000,14677674,36262783,23262783,1.7894448461538461
A Monster Calls,108.0,"Animation,Drama,Fantasy",7.5,70416,43000000,3740823,46414530,3414530,0.07940767441860465
Source Code,93.0,"Action,Drama,Sci-Fi",7.5,452036,32000000,54712227,140428499,108428499,3.38839059375
Southpaw,124.0,"Drama,Sport",7.4,199783,30000000,52421953,94156456,64156456,2.138548533333333
The Frozen Ground,105.0,"Crime,Drama,Mystery",6.4,51915,19200000,0,5617460,-13582540,-0.7074239583333334
The Imitation Game,114.0,"Biography,Drama,Thriller",8.0,620834,15000000,91125143,227740463,212740463,14.182697533333334
Bone Tomahawk,132.0,"Adventure,Drama,Horror",7.1,70298,2000000,0,475846,-1524154,-0.762077
Ask Me Anything,100.0,Drama,6.1,10680,950000,0,0,-950000,-1.0
Me and Earl and the Dying Girl,105.0,"Comedy,Drama,Romance",7.8,112627,8000000,6758416,9266180,1266180,0.1582725
The Dressmaker,119.0,"Comedy,Drama",7.1,46833,11900000,2022115,24041617,12141617,1.0203039495798318
Youth,124.0,"Comedy,Drama,Music",7.3,64418,13000000,2703296,24001573,11001573,0.8462748461538462
Replicas,107.0,"Drama,Sci-Fi,Thriller",5.4,17336,4000000,0,0,-4000000,-1.0
Sicario: Day of the Soldado,122.0,"Action,Crime,Drama",7.1,95650,35000000,50065850,75885196,40885196,1.168148457142857
Bad Times at the El Royale,141.0,"Crime,Drama,Mystery",7.1,86318,32000000,17839115,29204379,-2795621,-0.08736315625
Margaret,150.0,Drama,6.5,14708,14000000,47185,623292,-13376708,-0.9554791428571429
Sanctum,108.0,"Adventure,Drama,Thriller",5.9,51318,30000000,23209310,108957098,78957098,2.631903266666667
Maggie,95.0,"Drama,Horror",5.6,38671,4500000,187112,1027760,-3472240,-0.7716088888888889
The Reluctant Fundamentalist,130.0,"Drama,Thriller",6.9,12511,15000000,528731,528731,-14471269,-0.9647512666666667
The Gambler,111.0,"Crime,Drama,Thriller",6.0,59995,25000000,33680992,38718031,13718031,0.54872124
The Counselor,117.0,"Crime,Drama,Thriller",5.3,92096,25000000,16973715,71009334,46009334,1.84037336
Draft Day,110.0,"Drama,Sport",6.8,48812,25000000,28842237,29847480,4847480,0.1938992
Ain't Them Bodies Saints,96.0,"Crime,Drama,Romance",6.4,19464,5000000,391611,1075009,-3924991,-0.7849982
Dom Hemingway,93.0,"Comedy,Crime,Drama",6.2,24557,7000000,523511,1857458,-5142542,-0.7346488571428571
Midnight Special,112.0,"Action,Drama,Mystery",6.6,67921,18000000,3712282,7680250,-10319750,-0.5733194444444445
Trainwreck,125.0,"Comedy,Drama,Romance",6.2,121860,35000000,110212700,141123897,106123897,3.0321113428571427
Concussion,123.0,"Biography,Drama,Sport",7.1,77576,35000000,34531832,50363790,15363790,0.43896542857142856
Max,111.0,"Adventure,Drama,Family",6.8,23976,20000000,42656255,43658157,23658157,1.18290785
A Thousand Words,91.0,"Comedy,Drama",5.9,36387,40000000,18450127,20790486,-19209514,-0.48023785
Noah,138.0,"Action,Adventure,Drama",5.8,229326,130000000,101200044,352831065,222831065,1.7140851153846153
Begin Again,104.0,"Comedy,Drama,Music",7.4,129884,8000000,16170632,68838736,60838736,7.604842
Trouble with the Curve,111.0,"Drama,Sport",6.8,56129,60000000,35763137,47818913,-12181087,-0.20301811666666666
ABCD (Any Body Can Dance),160.0,"Drama,Music",6.4,5695,1900000,222098,10137234,8237234,4.335386315789473
The Dirties,83.0,"Crime,Drama",6.8,5728,55000,0,0,-55000,-1.0
Palo Alto,100.0,Drama,6.2,25402,1000000,767732,1156309,156309,0.156309
Ben-Hur,123.0,"Action,Adventure,Drama",5.7,37975,95000000,26410477,91669648,-3330352,-0.03505633684210526
Nightcrawler,117.0,"Crime,Drama,Thriller",7.9,404476,8500000,32381218,50334418,41834418,4.921696235294117
Manglehorn,97.0,Drama,5.6,6564,4000000,132270,797439,-3202561,-0.80064025
Allied,124.0,"Action,Drama,Romance",7.1,125741,106000000,40098064,119266661,13266661,0.12515717924528302
American Honey,163.0,"Adventure,Drama,Romance",7.0,31663,3500000,663247,2611750,-888250,-0.2537857142857143
Baby Driver,113.0,"Action,Crime,Drama",7.6,363977,34000000,107825862,228104185,194104185,5.708946617647059
Fifty Shades Freed,105.0,"Drama,Romance,Thriller",4.5,43893,55000000,100407760,371350619,316350619,5.751829436363637
Dangal,161.0,"Action,Biography,Drama",8.5,123638,9500000,12391761,294654618,285154618,30.01627557894737
Paterson,118.0,"Comedy,Drama,Romance",7.4,55285,5000000,2141423,10727536,5727536,1.1455072
Snitch,112.0,"Action,Drama,Thriller",6.5,78142,15000000,42930462,57907734,42907734,2.8605156
Argo,120.0,"Biography,Drama,Thriller",7.7,534683,44500000,136025503,227140757,182640757,4.104286674157303
Krisha,83.0,Drama,7.2,5917,30000,144822,144822,114822,3.8274
Loving,123.0,"Biography,Drama,Romance",7.0,28079,9000000,7710234,12898064,3898064,0.43311822222222224
The Promise,133.0,"Drama,History",6.1,164555,90000000,8224288,10551417,-79448583,-0.8827620333333334
Flipped,90.0,"Comedy,Drama,Romance",7.7,74937,14000000,1755212,4289993,-9710007,-0.6935719285714286
Black Swan,108.0,"Drama,Thriller",8.0,648854,13000000,106954678,331266710,318266710,24.482054615384616
Biutiful,148.0,"Drama,Romance",7.5,80382,35000000,5101237,24687524,-10312476,-0.2946421714285714
Quartet,94.0,"Comedy,Drama",6.8,17979,11000000,18388357,56178935,45178935,4.107175909090909
The Drop,106.0,"Crime,Drama",7.1,132161,12600000,10724389,19054534,6454534,0.5122646031746032
Cinderella,105.0,"Drama,Family,Fantasy",6.9,142792,95000000,201151353,534551353,439551353,4.626856347368421
Grudge Match,113.0,"Comedy,Drama,Sport",6.4,54080,40000000,29807260,69807260,29807260,0.7451815
The Little Prince,108.0,"Adventure,Animation,Drama",7.7,50015,77500000,1311213,102028919,24528919,0.3165021806451613
Inherent Vice,148.0,"Comedy,Crime,Drama",6.7,83346,20000000,8110975,14772346,-5227654,-0.2613827
The Perfect Guy,100.0,"Crime,Drama,Horror",5.6,8998,18000000,57027435,60278166,42278166,2.348787
Sultan,170.0,"Action,Drama,Sport",7.1,33371,11000000,5599781,72989781,61989781,5.6354346363636365
Dunkirk,106.0,"Action,Drama,History",7.9,466580,150000000,190068280,499837368,349837368,2.33224912
Blade Runner 2049,164.0,"Drama,Mystery,Sci-Fi",8.0,376241,185000000,92054159,259357408,74357408,0.40193193513513514
Trash,114.0,"Adventure,Crime,Drama",7.2,18690,12000000,17484,6553186,-5446814,-0.4539011666666667
The Accountant,128.0,"Action,Crime,Drama",7.3,233022,40000000,86260045,152962083,112962083,2.824052075
Bad Words,89.0,"Comedy,Drama",6.7,44061,10000000,7779614,7843145,-2156855,-0.2156855
Wild Card,92.0,"Action,Crime,Drama",5.6,46463,30000000,3200,4315789,-25684211,-0.8561403666666667
Blue Ruin,90.0,"Crime,Drama,Thriller",7.1,58811,420000,258384,437002,17002,0.04048095238095238
Left Behind,110.0,"Action,Drama,Fantasy",3.1,33515,18500000,4221341,4221341,-14278659,-0.7718194054054054
The Longest Ride,123.0,"Drama,Romance",7.1,70327,34000000,37446117,63802928,29802928,0.8765567058823529
The Lobster,119.0,"Comedy,Drama,Romance",7.1,182622,4500000,9196278,18019834,13519834,3.0044075555555554
Marshall,118.0,"Biography,Crime,Drama",7.2,14419,12000000,10051659,10116816,-1883184,-0.156932
Columbus,104.0,Drama,7.2,10735,700000,1017107,1110511,410511,0.5864442857142858
Trance,101.0,"Crime,Drama,Mystery",6.9,104951,16000000,2322593,22594052,6594052,0.41212825
Flatliners,109.0,"Drama,Horror,Mystery",5.2,33752,26000000,61308153,61308153,35308153,1.3580058846153846
"McFarland, USA",129.0,"Biography,Drama,Sport",7.4,31735,17000000,44480275,45707924,28707924,1.688701411764706
When the Game Stands Tall,115.0,"Drama,Family,Sport",6.7,14498,15000000,30127963,30138912,15138912,1.0092608
Magic Mike XXL,115.0,"Comedy,Drama,Music",5.6,48497,14500000,66013057,123660597,109160597,7.528317034482758
Forsaken,90.0,"Action,Drama,Western",6.3,9199,18000000,0,0,-18000000,-1.0
Mandela: Long Walk to Freedom,141.0,"Biography,Drama,History",7.1,25027,35000000,8323085,29890402,-5109598,-0.1459885142857143
Frances Ha,86.0,"Comedy,Drama,Romance",7.4,60026,3000000,4067398,11262769,8262769,2.754256333333333
The Intern,121.0,"Comedy,Drama",7.1,191494,40000000,75764672,197115710,157115710,3.92789275
Gloria,110.0,"Comedy,Drama,Romance",6.8,7640,30000000,4167493,4967493,-25032507,-0.8344169
Burnt,101.0,"Comedy,Drama",6.6,95988,20000000,13651946,36773510,16773510,0.8386755
Crimson Peak,119.0,"Drama,Fantasy,Horror",6.5,119287,55000000,31090320,74966854,19966854,0.3630337090909091
Jem and the Holograms,118.0,"Adventure,Drama,Family",4.1,6683,5000000,2184640,2368937,-2631063,-0.5262126
Ricki and the Flash,101.0,"Comedy,Drama,Music",5.9,20932,18000000,26839498,41166033,23166033,1.2870018333333333
If Beale Street Could Talk,119.0,"Drama,Romance",7.2,25512,12000000,14915773,19859167,7859167,0.6549305833333333
Life of Pi,127.0,"Adventure,Drama,Fantasy",7.9,535836,120000000,124987022,620912003,500912003,4.174266691666666
For Colored Girls,133.0,Drama,6.1,6728,21000000,37729698,38017873,17017873,0.8103749047619048
The Best Exotic Marigold Hotel,124.0,"Comedy,Drama,Romance",7.3,85811,10000000,46383639,134639780,124639780,12.463978
Gravity,91.0,"Drama,Sci-Fi,Thriller",7.7,710018,110000000,274092705,693698673,583698673,5.306351572727273
5 Days of War,113.0,"Action,Drama,War",5.6,13089,12000000,17479,87793,-11912207,-0.9926839166666667
Dolphin Tale,113.0,"Drama,Family",6.9,20746,37000000,72286779,96068724,59068724,1.596452
The Skeleton Twins,93.0,"Comedy,Drama,Romance",6.8,36793,1000000,5284309,5797192,4797192,4.797192
LOL,97.0,"Comedy,Drama,Romance",4.4,51424,11000000,0,10431506,-568494,-0.05168127272727273
Mirror Mirror,106.0,"Adventure,Comedy,Drama",5.6,79510,85000000,64935167,173613482,88613482,1.0425115529411764
Chronicle,84.0,"Drama,Sci-Fi,Thriller",7.1,229258,12000000,64575175,123681790,111681790,9.306815833333333
Moonrise Kingdom,94.0,"Adventure,Comedy,Drama",7.8,291750,16000000,45512466,68848446,52848446,3.303027875
The Bye Bye Man,96.0,"Drama,Fantasy,Horror",4.3,17743,7400000,22395806,31187727,23787727,3.214557702702703
Florence Foster Jenkins,111.0,"Biography,Comedy,Drama",6.8,44970,29000000,27383770,56000339,27000339,0.9310461724137931
The Gift,108.0,"Drama,Mystery,Thriller",7.1,123834,10000000,12008642,44567606,34567606,3.4567606
Robin Hood,140.0,"Action,Adventure,Drama",6.6,239480,210000000,105487148,322459006,112459006,0.5355190761904762
Almost Christmas,111.0,"Comedy,Drama",6.1,5212,17000000,42065185,42493506,25493506,1.499618
Hidden Figures,127.0,"Biography,Drama,History",7.8,171131,25000000,169607287,231771716,206771716,8.27086864
The Giver,97.0,"Drama,Romance,Sci-Fi",6.5,104999,25000000,45090374,66540205,41540205,1.6616082
The Social Network,120.0,"Biography,Drama",7.7,568578,40000000,96962694,224922135,184922135,4.623053375
The Beaver,91.0,Drama,6.7,45173,21000000,970816,5046038,-15953962,-0.7597124761904762
Lee Daniels' The Butler,132.0,"Biography,Drama",7.2,102468,30000000,116632095,177025498,147025498,4.900849933333333
What to Expect When You're Expecting,110.0,"Comedy,Drama,Romance",5.7,65890,37500000,41152203,88473016,50973016,1.3592804266666667
The Bronze,100.0,"Comedy,Drama,Sport",6.0,9043,3500000,615816,615816,-2884184,-0.8240525714285715
The Birth of a Nation,120.0,"Biography,Drama,History",6.4,18442,10000000,15861566,16891011,6891011,0.6891011
Widows,129.0,"Crime,Drama,Thriller",7.0,61615,40000000,42402632,73866088,33866088,0.8466522
Queen of Katwe,124.0,"Biography,Drama,Sport",7.4,13039,15000000,8874389,10055481,-4944519,-0.3296346
The Rum Diary,119.0,"Comedy,Drama",6.2,94787,45000000,13109815,21544732,-23455268,-0.5212281777777777
The Mule,103.0,"Comedy,Crime,Drama",6.3,5788,50000000,103804407,170857676,120857676,2.41715352
The Mule,116.0,"Crime,Drama,Thriller",7.1,58955,50000000,103804407,170857676,120857676,2.41715352
Jane Got a Gun,98.0,"Action,Drama,Western",5.9,19051,25000000,1513793,3771345,-21228655,-0.8491462
Money Monster,98.0,"Crime,Drama,Thriller",6.5,86607,27000000,41012075,93466095,66466095,2.461707222222222
And So It Goes,94.0,"Comedy,Drama,Romance",5.8,11597,18000000,15160801,17920013,-79987,-0.004443722222222222
The Second Best Exotic Marigold Hotel,122.0,"Comedy,Drama",6.6,28931,10000000,33078266,90384306,80384306,8.0384306
I Origins,106.0,"Drama,Romance,Sci-Fi",7.4,104718,1000000,336472,852399,-147601,-0.147601
Paper Towns,109.0,"Comedy,Drama,Mystery",6.3,87742,12000000,32000304,85450484,73450484,6.120873666666666
Conviction,107.0,"Biography,Crime,Drama",7.2,39771,12500000,6797696,11826980,-673020,-0.0538416
True Grit,110.0,"Adventure,Drama,Western",7.6,284034,35000000,171243005,252276928,217276928,6.207912228571429
Table 19,87.0,"Comedy,Drama,Romance",5.8,22751,5000000,3614896,4620399,-379601,-0.0759202
Big Miracle,107.0,"Biography,Drama,Family",6.5,17585,40000000,20157300,25268680,-14731320,-0.368283
Monsters,94.0,"Drama,Sci-Fi,Thriller",6.4,84332,500000,237301,5639730,5139730,10.27946
Albert Nobbs,113.0,"Drama,Romance",6.7,22213,7500000,3014696,8539003,1039003,0.13853373333333333
Bleed for This,117.0,"Biography,Drama,Sport",6.8,21946,16000000,5083906,6603926,-9396074,-0.587254625
Jersey Boys,134.0,"Biography,Drama,Music",6.8,30410,40000000,47047013,65282732,25282732,0.6320683
Gotti,112.0,"Biography,Crime,Drama",4.8,10358,10000000,4286367,6089100,-3910900,-0.39109
On the Basis of Sex,120.0,"Biography,Drama",6.9,12083,20000000,24622687,38073377,18073377,0.90366885
Baahubali 2: The Conclusion,167.0,"Action,Drama",8.3,65656,30000000,18985794,263502914,233502914,7.783430466666666
The Favourite,119.0,"Biography,Drama,History",7.6,116011,15000000,34366783,94113929,79113929,5.274261933333333
Lean on Pete,121.0,"Adventure,Drama",7.2,8607,8000000,1163056,2455027,-5544973,-0.693121625
Water for Elephants,120.0,"Drama,Romance",6.9,105812,38000000,58709717,116809717,78809717,2.0739399210526317
50/50,100.0,"Comedy,Drama,Romance",7.7,300475,8000000,35016118,41334735,33334735,4.166841875
Rise of the Planet of the Apes,105.0,"Action,Drama,Sci-Fi",7.6,473020,93000000,176760185,470986200,377986200,4.064367741935484
The Lucky One,101.0,"Drama,Romance",6.5,94359,25000000,60457138,96633833,71633833,2.86535332
Under the Skin,108.0,"Drama,Horror,Sci-Fi",6.3,113196,13300000,2614251,7229933,-6070067,-0.45639601503759397
Anonymous,130.0,"Drama,Thriller",6.9,37932,27500000,4463292,15815509,-11684491,-0.42489058181818185
Freeheld,103.0,"Biography,Drama,Romance",6.5,10534,7000000,546201,1732228,-5267772,-0.7525388571428572
Knock Knock,99.0,"Drama,Thriller",4.9,68328,2000000,36336,6328516,4328516,2.164258
Woodlawn,123.0,"Drama,Sport",6.5,6070,13000000,14394097,14403703,1403703,0.10797715384615385
Gifted,101.0,Drama,7.6,82426,7000000,24801212,36964656,29964656,4.280665142857143
Cold Pursuit,119.0,"Action,Crime,Drama",6.2,27648,60000000,32138862,62599159,2599159,0.04331931666666667
The Secret Life of Walter Mitty,114.0,"Adventure,Comedy,Drama",7.3,275300,91000000,58236838,187861183,96861183,1.0644086043956045
Nebraska,115.0,"Adventure,Comedy,Drama",7.7,105304,12000000,17654912,24761360,12761360,1.0634466666666667
Jab Tak Hai Jaan,176.0,"Drama,Romance",6.8,48364,9200000,3047539,5806666,-3393334,-0.36884065217391304
About Time,123.0,"Comedy,Drama,Fantasy",7.8,263136,12000000,15323921,89309178,77309178,6.4424315
Blue Jasmine,98.0,Drama,7.3,179453,18000000,33404871,102912961,84912961,4.717386722222222
The Lunchbox,104.0,"Drama,Romance",7.8,42618,1700000,4231500,12231500,10531500,6.195
The Homesman,122.0,"Drama,Western",6.6,27724,16000000,2429989,8217571,-7782429,-0.4864018125
Annihilation,115.0,"Adventure,Drama,Horror",6.9,228664,55000000,32732301,43070915,-11929085,-0.21689245454545455
Highway,133.0,"Crime,Drama,Romance",7.7,23434,2000000,0,0,-2000000,-1.0
Suffragette,106.0,"Biography,Drama,History",6.9,34306,14000000,4702420,34044909,20044909,1.4317792142857142
Circle,87.0,"Drama,Mystery,Sci-Fi",6.0,30645,2000000,10024,10024,-1989976,-0.994988
I Am Wrath,92.0,"Action,Crime,Drama",5.4,11198,18000000,0,309608,-17690392,-0.9827995555555555
Unsane,98.0,"Drama,Horror,Mystery",6.4,32049,1500000,7690044,14244931,12744931,8.496620666666667
The Sweeney,112.0,"Action,Crime,Drama",6.1,18095,4500000,26345,8000366,3500366,0.7778591111111111
Fair Game,108.0,"Biography,Drama,Thriller",6.8,43862,50000000,11497497,26097497,-23902503,-0.47805006
Edge of Darkness,117.0,"Crime,Drama,Mystery",6.6,84753,60000000,43313890,82812456,22812456,0.3802076
Another Year,129.0,"Comedy,Drama",7.3,26273,8000000,3205706,20005613,12005613,1.500701625
The Girl with the Dragon Tattoo,158.0,"Crime,Drama,Mystery",7.8,387580,90000000,102515793,239373970,149373970,1.6597107777777778
The Artist,100.0,"Comedy,Drama,Romance",7.9,217184,16000000,44667095,128256712,112256712,7.0160445
Trespass,91.0,"Crime,Drama,Thriller",5.3,39404,35000000,16816,786532,-34213468,-0.9775276571428572
Hands of Stone,111.0,"Action,Biography,Drama",6.6,12851,20000000,4712792,5031975,-14968025,-0.74840125
Annie,118.0,"Comedy,Drama,Family",5.3,31241,65000000,85911262,139829625,74829625,1.151225
Criminal Activities,94.0,"Crime,Drama,Thriller",5.8,7739,7000000,0,386744,-6613256,-0.9447508571428571
The Shallows,86.0,"Drama,Horror,Thriller",6.3,106927,13000000,55121623,118763442,105763442,8.135649384615384
White Boy Rick,111.0,"Crime,Drama",6.4,16255,30000000,24004833,25947983,-4052017,-0.13506723333333334
The Square,151.0,"Comedy,Drama",7.2,44239,1900000,406216,740932,-1159068,-0.6100357894736842
The Square,108.0,"Documentary,Drama,History",8.1,7998,1900000,406216,740932,-1159068,-0.6100357894736842
Boyhood,165.0,Drama,7.9,315584,4000000,25379975,57273049,53273049,13.31826225
The Rite,114.0,"Drama,Horror,Mystery",6.0,85604,37000000,33047633,97143987,60143987,1.6255131621621621
Let Me In,116.0,"Drama,Fantasy,Horror",7.1,107012,20000000,12134935,28270399,8270399,0.41351995
Contraband,109.0,"Action,Crime,Drama",6.5,111709,25000000,66528000,98406855,73406855,2.9362742
Elysium,109.0,"Action,Drama,Sci-Fi",6.6,395572,120000000,93050117,286192091,166192091,1.3849340916666666
The Son of No One,90.0,"Action,Crime,Drama",5.1,15743,15000000,30680,1148578,-13851422,-0.9234281333333333
A Dangerous Method,99.0,"Biography,Drama,Romance",6.4,93259,20000000,5702083,14807531,-5192469,-0.25962345
The Big Short,130.0,"Biography,Comedy,Drama",7.8,309227,28000000,70259870,133162752,105162752,3.7558125714285713
Our Idiot Brother,90.0,"Comedy,Drama",6.4,80738,5000000,24814830,25861249,20861249,4.1722498
The Age of Adaline,112.0,"Drama,Fantasy,Romance",7.2,138924,30000000,42629776,68984536,38984536,1.2994845333333334
People Like Us,114.0,"Comedy,Drama",7.1,39618,16000000,12431792,12617472,-3382528,-0.211408
The Fifth Estate,128.0,"Biography,Drama,Thriller",6.2,36392,26000000,3254172,6154172,-19845828,-0.7633010769230769
The Call,94.0,"Crime,Drama,Horror",6.7,103780,12800000,51872378,69821476,57021476,4.4548028125
Much Ado About Nothing,109.0,"Comedy,Drama,Romance",7.2,15415,8000000,22549338,22549338,14549338,1.81866725
Dawn of the Planet of the Apes,130.0,"Action,Adventure,Drama",7.6,390199,170000000,208545589,710644566,540644566,3.1802621529411765
Run All Night,114.0,"Action,Drama,Thriller",6.6,94131,50000000,26461644,66961644,16961644,0.33923288
The Canyons,99.0,"Drama,Thriller",3.8,9838,250000,59671,62375,-187625,-0.7505
Mary Queen of Scots,124.0,"Biography,Drama,History",6.3,23866,25000000,16468499,46734733,21734733,0.86938932
The Invitation,100.0,"Drama,Horror,Mystery",6.7,70213,1000000,231738,354836,-645164,-0.645164
Thank You for Your Service,109.0,"Biography,Drama,War",6.5,10006,20000000,9479390,9985316,-10014684,-0.5007342
Race,134.0,"Biography,Drama,Sport",7.1,30777,5000000,19115191,23745772,18745772,3.7491544
Misconduct,106.0,"Crime,Drama,Mystery",5.3,13550,11000000,0,2352511,-8647489,-0.7861353636363636
Hearts Beat Loud,97.0,"Comedy,Drama,Music",6.9,6543,2000000,2386254,2420962,420962,0.210481
Happy Death Day 2U,100.0,"Drama,Horror,Mystery",6.3,27462,9000000,28051045,64179495,55179495,6.131055
Unplanned,106.0,"Biography,Drama",6.3,5945,6000000,18107621,18107621,12107621,2.017936833333333
USS Indianapolis: Men of Courage,128.0,"Action,Drama,History",5.2,9453,40000000,0,1663785,-38336215,-0.958405375
Song One,86.0,"Drama,Music",5.8,8559,6000000,32251,437089,-5562911,-0.9271518333333333
Escobar: Paradise Lost,120.0,"Crime,Drama,History",6.5,19419,17000000,195792,3917679,-13082321,-0.769548294117647
Baahubali: The Beginning,159.0,"Action,Drama",8.1,93243,40000000,6738000,26736665,-13263335,-0.331583375
The Theory of Everything,123.0,"Biography,Drama,Romance",7.7,361534,15000000,35893537,123327692,108327692,7.221846133333333
The Jungle Book,106.0,"Adventure,Drama,Family",7.4,240821,175000000,364001123,962854547,787854547,4.502025982857143
The Disaster Artist,104.0,"Biography,Comedy,Drama",7.4,111737,10000000,21120616,28717667,18717667,1.8717667
Dallas Buyers Club,117.0,"Biography,Drama",8.0,402462,5000000,27298285,60611845,55611845,11.122369
The Conspirator,122.0,"Crime,Drama,History",6.9,26416,25000000,11538204,15907411,-9092589,-0.36370356
Brighton Rock,111.0,"Crime,Drama,Thriller",5.7,5784,11000000,229653,229653,-10770347,-0.9791224545454545
The Future,91.0,"Drama,Fantasy,Romance",6.2,7648,1000000,568662,1239174,239174,0.239174
Dying of the Light,94.0,"Drama,Thriller",4.4,8888,5000000,0,74639,-4925361,-0.9850722
Prisoners,153.0,"Crime,Drama,Mystery",8.1,526273,46000000,61002302,113402302,67402302,1.4652674347826087
Hesher,106.0,"Comedy,Crime,Drama",7.0,48483,7000000,382946,382946,-6617054,-0.9452934285714286
The Paperboy,107.0,"Crime,Drama,Mystery",5.8,33940,12500000,677200,4027663,-8472337,-0.67778696
Restless,91.0,"Drama,Romance",6.8,16736,8000000,163753,2772511,-5227489,-0.653436125
Battle of the Year,110.0,"Drama,Music",5.1,8769,20000000,8888355,16723377,-3276623,-0.16383115
Million Dollar Arm,124.0,"Biography,Drama,Sport",7.0,41008,25000000,36447959,39217912,14217912,0.56871648
The Impossible,114.0,"Drama,History,Thriller",7.6,177762,40000000,19019882,169590606,129590606,3.23976515
All Eyez on Me,139.0,"Biography,Drama,Music",5.8,18541,45000000,44922302,54876855,9876855,0.21948566666666666
Joyful Noise,118.0,"Comedy,Drama,Music",5.8,7575,27500000,30932113,31157914,3657914,0.13301505454545454
The Place Beyond the Pines,140.0,"Crime,Drama,Thriller",7.3,226765,15000000,21403519,47011449,32011449,2.1340966
Bridge of Spies,142.0,"Drama,History,Thriller",7.6,263004,40000000,72313754,162498338,122498338,3.06245845
Brothers,156.0,"Action,Drama,Sport",6.7,10689,26000000,28544157,45043870,19043870,0.7324565384615385
Mustang,97.0,Drama,7.6,30899,1400000,845464,5552584,4152584,2.9661314285714284
Alpha,96.0,"Adventure,Drama,Family",6.7,41882,51000000,35851379,99624873,48624873,0.9534288823529412
Sleight,89.0,"Action,Drama,Sci-Fi",5.9,7074,250000,3930990,3934450,3684450,14.7378
"I, Tonya",120.0,"Biography,Comedy,Drama",7.5,141668,11000000,30014534,53797409,42797409,3.8906735454545456
Kin,102.0,"Action,Drama,Sci-Fi",5.7,9048,30000000,5718096,10096821,-19903179,-0.6634393
Holy Motors,115.0,"Drama,Fantasy",7.1,36874,4000000,641054,4230426,230426,0.0576065
Spring Breakers,94.0,"Comedy,Crime,Drama",5.3,126504,5000000,14124286,31149251,26149251,5.2298502
Hacksaw Ridge,139.0,"Biography,Drama,History",8.1,366904,40000000,67209615,168904682,128904682,3.22261705
Drinking Buddies,90.0,"Comedy,Drama,Romance",6.1,53546,500000,343706,407100,-92900,-0.1858
Wonder,113.0,"Drama,Family",8.0,111632,20000000,132422809,304604712,284604712,14.2302356
Criminal,113.0,"Action,Crime,Drama",6.3,51666,31500000,14708696,38771262,7271262,0.23083371428571428
The Diary of a Teenage Girl,102.0,"Comedy,Drama,Romance",6.9,27003,2000000,1477002,2279959,279959,0.1399795
Logan,137.0,"Action,Drama,Sci-Fi",8.1,560270,127000000,226277068,615461394,488461394,3.846152708661417
Red Dog,92.0,"Biography,Comedy,Drama",7.4,15357,9100000,0,20927794,11827794,1.2997575824175824
Flight,138.0,"Drama,Thriller",7.3,303009,31000000,93772375,160558438,129558438,4.179304451612904
Indie Game: The Movie,103.0,"Documentary,Drama",7.7,19538,100000,0,0,-100000,-1.0
The Best of Me,118.0,"Drama,Romance",6.7,59750,26000000,26766213,41059418,15059418,0.5792083846153846
Don Jon,90.0,"Comedy,Drama,Romance",6.6,216350,5500000,24477704,41268579,35768579,6.503378
The Rover,103.0,"Action,Crime,Drama",6.4,40576,8500000,1109199,3180252,-5319748,-0.625852705882353
Anomalisa,90.0,"Animation,Comedy,Drama",7.3,58010,8000000,3759286,5706168,-2293832,-0.286729
The Light Between Oceans,133.0,"Drama,Romance",7.2,46247,20000000,12545979,22281732,2281732,0.1140866
The D Train,101.0,"Comedy,Drama",5.0,10066,3000000,669688,772366,-2227634,-0.7425446666666666
A Most Violent Year,125.0,"Crime,Drama,Thriller",7.0,60165,20000000,5749134,8846875,-11153125,-0.55765625
Son of God,138.0,"Biography,Drama,History",5.8,17606,22000000,59700064,70949793,48949793,2.224990590909091
War for the Planet of the Apes,140.0,"Action,Adventure,Drama",7.5,201943,152000000,146880162,489592267,337592267,2.2210017565789473
The Hateful Eight,168.0,"Crime,Drama,Mystery",7.8,434966,62000000,54117416,147864886,85864886,1.3849175161290324
Morning Glory,107.0,"Comedy,Drama,Romance",6.5,67367,40000000,31011732,59795070,19795070,0.49487675
Rock of Ages,123.0,"Comedy,Drama,Musical",5.9,69910,70000000,38518613,61031932,-8968068,-0.12811525714285715
Four Lions,97.0,"Comedy,Crime,Drama",7.3,66209,3750000,310007,2436111,-1313889,-0.3503704
Coriolanus,123.0,"Drama,Thriller,War",6.1,29654,10000000,749641,2179623,-7820377,-0.7820377
Super,96.0,"Action,Comedy,Drama",6.8,70604,2500000,327716,593933,-1906067,-0.7624268
Hope Springs,100.0,"Comedy,Drama,Romance",6.3,38667,30000000,63536011,133085295,103085295,3.4361765
Point Blank,81.0,"Action,Crime,Drama",6.8,12706,3000000,0,0,-3000000,-1.0
Amour,127.0,"Drama,Romance",7.9,84960,9700000,6738954,36787044,27087044,2.792478762886598
Margin Call,107.0,"Drama,Thriller",7.1,107264,3400000,5353586,20433227,17033227,5.009772647058823
Stoker,99.0,"Drama,Thriller",6.8,97393,12000000,1703125,12034913,34913,0.0029094166666666665
Circumstance,107.0,Drama,5.9,7055,900000,454121,958978,58978,0.06553111111111111
Genius,104.0,"Biography,Drama",6.6,15611,17000000,1361045,7265283,-9734717,-0.5726304117647059
Tarzan,94.0,"Adventure,Animation,Drama",4.8,11728,145000000,171091819,448191819,303191819,2.0909780620689653
Killer Joe,102.0,"Crime,Drama,Thriller",6.7,67842,10000000,1291645,4659110,-5340890,-0.534089
Bohemian Rhapsody,134.0,"Biography,Drama,Music",8.0,345466,55000000,216303339,894985342,839985342,15.272460763636364
Miracles from Heaven,109.0,"Biography,Drama,Family",7.1,17734,13000000,61705123,73798736,60798736,4.6768258461538466
The Professor and the Madman,124.0,"Biography,Drama,Mystery",7.4,10383,25000000,0,5227233,-19772767,-0.79091068
Wuthering Heights,129.0,"Drama,Romance",6.1,8549,8000000,100915,2721534,-5278466,-0.65980825
Last Vegas,105.0,"Comedy,Drama",6.6,121409,28000000,63914167,112914167,84914167,3.0326488214285714
Den of Thieves,140.0,"Action,Crime,Drama",7.0,69648,30000000,44947622,80131391,50131391,1.6710463666666666
Passengers,116.0,"Drama,Romance,Sci-Fi",7.0,311083,110000000,100014699,302239672,192239672,1.7476333818181817
Kill the Irishman,106.0,"Biography,Crime,Drama",7.1,41504,12000000,1188194,1188194,-10811806,-0.9009838333333333
Somewhere,97.0,"Comedy,Drama",6.3,40250,7000000,1785645,17023121,10023121,1.4318744285714287
Stone,105.0,"Drama,Thriller",5.4,38667,22000000,1810078,4065020,-17934980,-0.8152263636363636
Charlie St. Cloud,99.0,"Drama,Fantasy,Romance",6.5,55016,44000000,31206263,48478084,4478084,0.10177463636363636
Exodus: Gods and Kings,150.0,"Action,Adventure,Drama",6.0,150858,140000000,65014513,268314513,128314513,0.9165322357142857
Country Strong,117.0,"Drama,Music",6.3,16296,15000000,20218921,20601987,5601987,0.3734658
Honey,103.0,Drama,7.2,6221,18000000,30272254,62646763,44646763,2.480375722222222
We Are Your Friends,96.0,"Drama,Music,Romance",6.2,32327,2000000,3591417,10153415,8153415,4.0767075
Stronger,119.0,"Biography,Drama",7.0,33464,30000000,4211129,8786752,-21213248,-0.7071082666666667
Ouija: Origin of Evil,99.0,"Drama,Horror,Mystery",6.1,47099,9000000,35144505,81831866,72831866,8.092429555555556
The Meddler,103.0,"Comedy,Drama,Romance",6.3,10629,3200000,4267219,5526942,2326942,0.727169375
The Switch,101.0,"Comedy,Drama,Romance",6.1,90661,19000000,27758465,49858465,30858465,1.6241297368421053
Dear John,108.0,"Drama,Romance,War",6.3,128657,25000000,80014842,142033509,117033509,4.68134036
Straw Dogs,110.0,"Action,Drama,Thriller",5.8,30924,25000000,10324441,11253821,-13746179,-0.54984716
American Hustle,138.0,"Crime,Drama",7.2,418221,40000000,150117807,257878294,217878294,5.44695735
Miss Bala,113.0,"Crime,Drama,Thriller",6.5,8092,15000000,14998027,15362298,362298,0.0241532
Escape from Tomorrow,90.0,"Drama,Fantasy,Horror",5.2,8665,650000,171962,171962,-478038,-0.735443076923077
The 5th Wave,112.0,"Action,Adventure,Drama",5.2,90788,38000000,34912982,111336398,73336398,1.9299052105263157
Cheap Thrills,88.0,"Comedy,Crime,Drama",6.7,16429,100000,59424,59424,-40576,-0.40576
Creed,133.0,"Drama,Sport",7.6,224671,37000000,109767581,173567581,136567581,3.691015702702703
Life as We Know It,114.0,"Comedy,Drama,Romance",6.6,113077,38000000,53374681,105887837,67887837,1.7865220263157895
All Good Things,101.0,"Crime,Drama,Mystery",6.3,49684,20000000,582024,873617,-19126383,-0.95631915
We Need to Talk About Kevin,112.0,"Drama,Mystery,Thriller",7.5,123619,7000000,1738692,10765283,3765283,0.5378975714285714
Faster,98.0,"Action,Crime,Drama",6.5,93618,24000000,23240020,35792945,11792945,0.49137270833333335
Testament of Youth,129.0,"Biography,Drama,History",7.3,23632,10000000,1822250,6646669,-3353331,-0.3353331
Fantastic Four,100.0,"Action,Adventure,Drama",4.3,140148,120000000,56117548,167849187,47849187,0.398743225
Trust,106.0,"Crime,Drama,Thriller",6.9,39422,4000000,120016,120016,-3879984,-0.969996
War Horse,146.0,"Drama,History,War",7.2,136447,70000000,79883359,156815529,86815529,1.2402218428571428
The Art of Getting By,83.0,"Drama,Romance",6.6,53682,4000000,1430241,1989035,-2010965,-0.50274125
Sabotage,109.0,"Action,Crime,Drama",5.7,55597,35000000,10508518,18376443,-16623557,-0.4749587714285714
Blood Ties,127.0,"Action,Crime,Drama",6.5,17771,26000000,42472,2923959,-23076041,-0.8875400384615385
Arbitrage,107.0,"Drama,Thriller",6.6,46774,12000000,7919574,35830713,23830713,1.98589275
Wilson,94.0,"Comedy,Drama",5.8,8985,5200000,2000000,2000000,-3200000,-0.6153846153846154
Rudderless,105.0,"Comedy,Drama,Music",7.5,16303,5000000,56001,567219,-4432781,-0.8865562
After Earth,100.0,"Action,Adventure,Drama",4.8,181687,130000000,60522097,251499665,121499665,0.9346128076923077
Chappie,120.0,"Action,Crime,Drama",6.8,213733,49000000,31569268,105002056,56002056,1.1428991020408164
Battle of the Sexes,121.0,"Biography,Comedy,Drama",6.7,43245,25000000,12638526,18445379,-6554621,-0.26218484
Denial,109.0,"Biography,Drama",6.7,16593,10000000,4073448,9263940,-736060,-0.073606
A Quiet Place,90.0,"Drama,Horror,Sci-Fi",7.6,305031,17000000,188024361,334522294,317522294,18.677782
Peppermint,101.0,"Action,Crime,Drama",6.5,35854,25000000,35418723,51800758,26800758,1.07203032
Drive,100.0,"Crime,Drama",7.8,521495,15000000,35060689,81357930,66357930,4.423862
The Upside,126.0,"Comedy,Drama",6.7,24169,37500000,108235497,119024536,81524536,2.1739876266666665
Beasts of the Southern Wild,93.0,"Adventure,Drama,Fantasy",7.3,77440,1800000,12795746,23265132,21465132,11.925073333333334
A Hologram for the King,98.0,"Comedy,Drama,Romance",6.1,36062,35000000,4212494,11846010,-23153990,-0.6615425714285714
Beyond the Lights,116.0,"Drama,Music,Romance",6.9,14122,7000000,14618727,14618727,7618727,1.0883895714285714
