movie,runtime_minutes,genres,averagerating,numvotes,production_budget,domestic_gross,worldwide_gross,net_revenue,ROI%
The Legend of Hercules,99.0,"Action,Adventure,Fantasy",4.2,50352,70000000,18848538,58953319,-11046681,-0.15780972857142858
Hereafter,129.0,"Drama,Fantasy,Romance",6.5,87288,50000000,32746941,108660270,58660270,1.1732054
Don't Be Afraid of the Dark,99.0,"Fantasy,Horror,Thriller",5.6,44490,25000000,24046682,39126427,14126427,0.56505708
The Adventurer: The Curse of the Midas Box,100.0,"Adventure,Family,Fantasy",5.4,5257,25000000,0,0,-25000000,-1.0
Cirque du Soleil: Worlds Away,91.0,Fantasy,6.8,7643,25000000,12512862,28012862,3012862,0.12051448
A Little Bit of Heaven,106.0,"Comedy,Drama,Fantasy",6.3,26441,12500000,10011,1100287,-11399713,-0.91197704
Abraham Lincoln: Vampire Hunter,105.0,"Action,Fantasy,Horror",5.9,142853,67500000,37519139,137489730,69989730,1.0368848888888889
The Last Witch Hunter,106.0,"Action,Adventure,Fantasy",6.0,86118,80000000,27367660,130818912,50818912,0.6352364
Beautiful Creatures,124.0,"Drama,Fantasy,Romance",6.2,79764,50000000,19452138,60282876,10282876,0.20565752
Winchester,99.0,"Biography,Drama,Fantasy",5.4,24351,3500000,25091816,44378040,40878040,11.67944
Hercules,98.0,"Action,Adventure,Fantasy",6.0,137287,100000000,72688614,243388614,143388614,1.43388614
Pirates of the Caribbean: On Stranger Tides,136.0,"Action,Adventure,Fantasy",6.6,447624,410600000,241063875,1045663875,635063875,1.5466728567949342
Jack the Giant Slayer,114.0,"Adventure,Fantasy",6.3,123127,195000000,65187603,197687603,2687603,0.013782579487179487
Rubber,82.0,"Comedy,Fantasy,Horror",5.8,31316,500000,100370,680914,180914,0.361828
Dracula Untold,92.0,"Action,Drama,Fantasy",6.3,164829,70000000,55991880,220241723,150241723,2.1463103285714284
The Hobbit: An Unexpected Journey,169.0,"Adventure,Family,Fantasy",7.9,719629,250000000,303003568,1017003568,767003568,3.068014272
Godzilla: King of the Monsters,132.0,"Action,Adventure,Fantasy",6.7,36479,170000000,85576941,299276941,129276941,0.7604525941176471
Immortals,110.0,"Action,Drama,Fantasy",6.0,152992,75000000,83504017,211562435,136562435,1.8208324666666666
The Twilight Saga: Eclipse,124.0,"Adventure,Drama,Fantasy",5.0,211733,68000000,300531751,706102828,638102828,9.383865117647058
If I Stay,107.0,"Drama,Fantasy,Music",6.8,107625,11000000,50474843,78356170,67356170,6.1232881818181815
Drive Angry,104.0,"Action,Fantasy,Thriller",5.4,90203,50000000,10721033,41042583,-8957417,-0.17914834
Warcraft,123.0,"Action,Adventure,Fantasy",6.9,225557,160000000,47225655,425522281,265522281,1.65951425625
Valerian and the City of a Thousand Planets,137.0,"Action,Adventure,Fantasy",6.5,139792,180000000,40479370,215098356,35098356,0.19499086666666668
Jonah Hex,81.0,"Action,Drama,Fantasy",4.7,51860,47000000,10547117,11022696,-35977304,-0.7654745531914894
Upside Down,109.0,"Drama,Fantasy,Romance",6.4,66347,50000000,102118,26387039,-23612961,-0.47225922
The Change-Up,112.0,"Comedy,Fantasy",6.3,155374,52000000,37243418,75997067,23997067,0.4614820576923077
Fantastic Beasts: The Crimes of Grindelwald,134.0,"Adventure,Family,Fantasy",6.6,163151,200000000,159555901,652220086,452220086,2.26110043
Ender's Game,114.0,"Action,Adventure,Fantasy",6.6,211722,110000000,61737191,127983283,17983283,0.16348439090909092
Red Lights,114.0,"Drama,Fantasy,Horror",6.2,55287,17700000,49521,14518884,-3181116,-0.17972406779661018
Wonder Woman,141.0,"Action,Adventure,Fantasy",7.5,487527,150000000,412563408,821133378,671133378,4.47422252
Season of the Witch,95.0,"Action,Adventure,Fantasy",5.4,85777,40000000,24827228,91126600,51126600,1.278165
Mortal Engines,128.0,"Action,Adventure,Fantasy",6.1,70193,100000000,15951040,85287417,-14712583,-0.14712583
Legion,100.0,"Action,Fantasy,Horror",5.2,92709,26000000,40168080,67647574,41647574,1.6018297692307693
Conan the Barbarian,113.0,"Action,Adventure,Fantasy",5.2,90834,90000000,21295021,63356133,-26643867,-0.2960429666666667
The BFG,117.0,"Adventure,Family,Fantasy",6.4,69340,140000000,55483770,199646680,59646680,0.4260477142857143
Alice in Wonderland,108.0,"Adventure,Family,Fantasy",6.5,358813,200000000,334191110,1025491110,825491110,4.12745555
Ghost Rider: Spirit of Vengeance,96.0,"Action,Fantasy,Thriller",4.3,103608,57000000,51774002,149217355,92217355,1.6178483333333333
Love the Coopers,107.0,"Comedy,Fantasy,Romance",5.8,18018,18000000,26302731,42227490,24227490,1.3459716666666666
A Haunted House 2,86.0,"Comedy,Fantasy",4.7,18085,4000000,17329487,21206861,17206861,4.30171525
Batman v Superman: Dawn of Justice,151.0,"Action,Adventure,Fantasy",6.5,576909,250000000,330360194,867500281,617500281,2.470001124
Solo: A Star Wars Story,135.0,"Action,Adventure,Fantasy",7.0,226243,275000000,213767512,393151347,118151347,0.4296412618181818
Thor,115.0,"Action,Adventure,Fantasy",7.0,683264,150000000,181030624,449326618,299326618,1.9955107866666666
Priest,87.0,"Action,Adventure,Fantasy",5.7,108320,60000000,29136626,84154026,24154026,0.4025671
The Final Girls,88.0,"Comedy,Drama,Fantasy",6.6,30219,4500000,0,0,-4500000,-1.0
Lost River,95.0,"Drama,Fantasy,Mystery",5.8,15667,2000000,45431,2009644,9644,0.004822
Gods of Egypt,127.0,"Action,Adventure,Fantasy",5.4,95111,140000000,31153464,138836756,-1163244,-0.008308885714285714
Kong: Skull Island,118.0,"Action,Adventure,Fantasy",6.6,237720,185000000,168052812,561072059,376072059,2.0328219405405403
The Shape of Water,123.0,"Adventure,Drama,Fantasy",7.3,308112,19500000,63859435,195790794,176290794,9.040553538461538
Wolves,91.0,"Action,Fantasy,Horror",5.3,7312,18000000,0,94953,-17905047,-0.9947248333333333
Midnight in Paris,94.0,"Comedy,Fantasy,Romance",7.7,356500,30000000,56816662,162502774,132502774,4.416759133333334
The Tree of Life,139.0,"Drama,Fantasy",6.8,156266,35000000,13305665,61721826,26721826,0.7634807428571428
The Hobbit: The Desolation of Smaug,161.0,"Adventure,Fantasy",7.8,565563,250000000,258366855,960366855,710366855,2.84146742
300: Rise of an Empire,102.0,"Action,Fantasy,War",6.2,262978,110000000,106580051,330780051,220780051,2.0070913727272726
The Incredible Burt Wonderstone,100.0,"Adventure,Comedy,Fantasy",5.9,67549,32000000,22537881,27392609,-4607391,-0.14398096875
The Mortal Instruments: City of Bones,130.0,"Action,Fantasy,Horror",5.9,121936,60000000,31165421,75965567,15965567,0.26609278333333336
Wrath of the Titans,99.0,"Action,Adventure,Fantasy",5.7,172330,150000000,83670083,305270083,155270083,1.0351338866666666
Dumbo,112.0,"Adventure,Family,Fantasy",6.6,25072,170000000,113883318,345004422,175004422,1.0294377764705882
The Wall,108.0,"Drama,Fantasy,Mystery",6.8,5484,3000000,1803064,4495262,1495262,0.4984206666666667
The Brass Teapot,101.0,"Comedy,Fantasy,Thriller",6.4,13746,900000,6997,413733,-486267,-0.5402966666666666
The Night Before,101.0,"Adventure,Comedy,Fantasy",6.4,58455,25000000,43035725,52427346,27427346,1.09709384
The Woman in Black,95.0,"Drama,Fantasy,Horror",6.4,165357,15000000,54333290,128955898,113955898,7.597059866666667
The Dark Tower,95.0,"Action,Adventure,Fantasy",5.7,107518,60000000,50701325,113461527,53461527,0.89102545
Yoga Hosers,88.0,"Action,Comedy,Fantasy",4.3,10483,5000000,0,22958,-4977042,-0.9954084
"I, Frankenstein",92.0,"Action,Fantasy,Horror",5.1,74910,65000000,19075290,74575290,9575290,0.14731215384615384
Red Riding Hood,100.0,"Fantasy,Horror,Mystery",5.5,102369,42000000,37662162,91678442,49678442,1.1828200476190476
What Men Want,117.0,"Comedy,Fantasy,Romance",4.9,10141,20000000,54611903,69911903,49911903,2.49559515
Alice Through the Looking Glass,113.0,"Adventure,Family,Fantasy",6.2,79951,170000000,77042381,276928112,106928112,0.628988894117647
Beastly,86.0,"Drama,Fantasy,Romance",5.6,72599,17000000,27865571,38028230,21028230,1.236954705882353
Suicide Squad,123.0,"Action,Adventure,Fantasy",6.0,533039,175000000,325100054,746059887,571059887,3.2631993542857143
A Wrinkle in Time,109.0,"Adventure,Family,Fantasy",4.2,34888,103000000,100478608,133401882,30401882,0.29516390291262135
The Wolfman,103.0,"Drama,Fantasy,Horror",5.8,97873,150000000,62189884,142634358,-7365642,-0.04910428
Percy Jackson & the Olympians: The Lightning Thief,118.0,"Adventure,Family,Fantasy",5.9,165108,95000000,88768303,223050874,128050874,1.3479039368421053
A Ghost Story,92.0,"Drama,Fantasy,Romance",6.8,46280,100000,1594798,2769782,2669782,26.69782
Hansel & Gretel: Witch Hunters,88.0,"Action,Fantasy,Horror",6.1,183387,50000000,55703475,214949716,164949716,3.29899432
Wish Upon,90.0,"Drama,Fantasy,Horror",5.0,14962,12000000,14301505,23477345,11477345,0.9564454166666667
Percy Jackson: Sea of Monsters,106.0,"Adventure,Family,Fantasy",5.8,102313,90000000,68559554,200859554,110859554,1.2317728222222222
Beauty and the Beast,129.0,"Family,Fantasy,Musical",7.2,238325,160000000,504014165,1259199706,1099199706,6.8699981625
Beauty and the Beast,112.0,"Drama,Fantasy,Romance",6.4,18100,160000000,504014165,1259199706,1099199706,6.8699981625
Clash of the Titans,106.0,"Action,Adventure,Fantasy",5.8,256176,125000000,163214888,493214888,368214888,2.945719104
Justice League,120.0,"Action,Adventure,Fantasy",6.5,329135,300000000,229024295,655945209,355945209,1.18648403
The Warrior's Way,100.0,"Action,Fantasy,Western",6.3,24271,42000000,5666340,8514325,-33485675,-0.7972779761904762
Seventh Son,102.0,"Action,Adventure,Fantasy",5.5,66565,95000000,17725785,108874967,13874967,0.14605228421052632
The Tempest,110.0,"Comedy,Drama,Fantasy",5.4,7073,20000000,277943,277943,-19722057,-0.98610285
Oz the Great and Powerful,130.0,"Adventure,Family,Fantasy",6.3,192045,200000000,234770996,490359051,290359051,1.451795255
Mandy,121.0,"Action,Fantasy,Horror",6.6,44378,6000000,1214525,1427656,-4572344,-0.7620573333333334
Tomb Raider,119.0,"Action,Adventure,Fantasy",6.3,163560,90000000,58250803,273477501,183477501,2.0386389
Before I Fall,98.0,"Drama,Fantasy,Mystery",6.4,39282,5000000,12241072,18945682,13945682,2.7891364
Twixt,88.0,"Comedy,Fantasy,Horror",4.8,9774,7000000,0,1268346,-5731654,-0.8188077142857143
A Monster Calls,108.0,"Animation,Drama,Fantasy",7.5,70416,43000000,3740823,46414530,3414530,0.07940767441860465
Thor: The Dark World,112.0,"Action,Adventure,Fantasy",6.9,540996,150000000,206362140,644602516,494602516,3.297350106666667
Krampus,98.0,"Comedy,Fantasy,Horror",6.2,55400,15000000,42725475,61788393,46788393,3.1192262
Sucker Punch,110.0,"Action,Adventure,Fantasy",6.1,218371,75000000,36392502,89758389,14758389,0.19677852
The Nutcracker and the Four Realms,99.0,"Adventure,Family,Fantasy",5.5,18734,132900000,54858851,170293899,37393899,0.281368690744921
Underworld: Blood Wars,91.0,"Action,Adventure,Fantasy",5.8,62942,35000000,30353973,81209222,46209222,1.3202634857142856
Cinderella,105.0,"Drama,Family,Fantasy",6.9,142792,95000000,201151353,534551353,439551353,4.626856347368421
The Mummy,110.0,"Action,Adventure,Fantasy",5.5,154345,195000000,80101125,409953905,214953905,1.1023277179487179
Left Behind,110.0,"Action,Drama,Fantasy",3.1,33515,18500000,4221341,4221341,-14278659,-0.7718194054054054
Crimson Peak,119.0,"Drama,Fantasy,Horror",6.5,119287,55000000,31090320,74966854,19966854,0.3630337090909091
Life of Pi,127.0,"Adventure,Drama,Fantasy",7.9,535836,120000000,124987022,620912003,500912003,4.174266691666666
Evil Dead,91.0,"Fantasy,Horror,Thriller",6.5,146399,17000000,54239856,97778356,80778356,4.751668
Aquaman,143.0,"Action,Adventure,Fantasy",7.1,263328,160000000,335061807,1146894640,986894640,6.1680915
Pirates of the Caribbean: Dead Men Tell No Tales,129.0,"Action,Adventure,Fantasy",6.6,228592,230000000,172558876,788241137,558241137,2.4271353782608696
The Bye Bye Man,96.0,"Drama,Fantasy,Horror",4.3,17743,7400000,22395806,31187727,23787727,3.214557702702703
Mary Poppins Returns,130.0,"Comedy,Family,Fantasy",6.9,52103,130000000,171958438,341528518,211528518,1.6271424461538462
Doctor Strange,115.0,"Action,Adventure,Fantasy",7.5,514510,165000000,232641920,676404566,511404566,3.099421612121212
Bright,117.0,"Action,Crime,Fantasy",6.4,147834,90000000,0,0,-90000000,-1.0
About Time,123.0,"Comedy,Drama,Fantasy",7.8,263136,12000000,15323921,89309178,77309178,6.4424315
Hellboy,120.0,"Action,Adventure,Fantasy",5.4,19534,60000000,59623958,99823958,39823958,0.6637326333333333
Fantastic Beasts and Where to Find Them,132.0,"Adventure,Family,Fantasy",7.3,365353,180000000,234037575,802402853,622402853,3.457793627777778
Dark Shadows,113.0,"Comedy,Fantasy,Horror",6.2,229818,150000000,79727149,238202668,88202668,0.5880177866666667
Let Me In,116.0,"Drama,Fantasy,Horror",7.1,107012,20000000,12134935,28270399,8270399,0.41351995
The Age of Adaline,112.0,"Drama,Fantasy,Romance",7.2,138924,30000000,42629776,68984536,38984536,1.2994845333333334
Tooth Fairy,101.0,"Comedy,Family,Fantasy",5.0,37939,48000000,60022256,112610386,64610386,1.3460497083333334
The Future,91.0,"Drama,Fantasy,Romance",6.2,7648,1000000,568662,1239174,239174,0.239174
Holy Motors,115.0,"Drama,Fantasy",7.1,36874,4000000,641054,4230426,230426,0.0576065
A Haunted House,86.0,"Comedy,Fantasy",5.1,40308,2500000,40041683,59922558,57422558,22.9690232
The Hobbit: The Battle of the Five Armies,144.0,"Adventure,Fantasy",7.4,438621,250000000,255119788,945577621,695577621,2.782310484
Your Highness,102.0,"Adventure,Comedy,Fantasy",5.5,92940,50000000,21596445,26121638,-23878362,-0.47756724
Ghostbusters,116.0,"Action,Comedy,Fantasy",5.2,186788,144000000,128350574,229008658,85008658,0.5903379027777778
Charlie St. Cloud,99.0,"Drama,Fantasy,Romance",6.5,55016,44000000,31206263,48478084,4478084,0.10177463636363636
Sorry to Bother You,111.0,"Comedy,Fantasy,Sci-Fi",7.0,40290,3200000,17493096,18285560,15085560,4.7142375
The Great Wall,103.0,"Action,Adventure,Fantasy",6.0,111602,150000000,45157105,334486852,184486852,1.2299123466666666
Escape from Tomorrow,90.0,"Drama,Fantasy,Horror",5.2,8665,650000,171962,171962,-478038,-0.735443076923077
Ted,106.0,"Comedy,Fantasy",6.9,538367,50000000,218665740,556016627,506016627,10.12033254
The Chronicles of Narnia: The Voyage of the Dawn Treader,113.0,"Adventure,Family,Fantasy",6.3,129663,155000000,104386950,418186950,263186950,1.6979803225806451
Suspiria,152.0,"Fantasy,Horror,Mystery",6.8,37360,20000000,2483472,7034615,-12965385,-0.64826925
Beasts of the Southern Wild,93.0,"Adventure,Drama,Fantasy",7.3,77440,1800000,12795746,23265132,21465132,11.925073333333334
