movie,runtime_minutes,genres,averagerating,numvotes,production_budget,domestic_gross,worldwide_gross,net_revenue,ROI%
Shanghai,105.0,"Crime,Drama,Mystery",6.4,8662,50000000,46425,15505922,-34494078,-0.68988156
Shanghai,120.0,"Crime,Mystery,Thriller",7.2,9047,50000000,46425,15505922,-34494078,-0.68988156
The Commuter,105.0,"Action,Mystery,Thriller",6.3,83114,40000000,36343858,101985431,61985431,1.549635775
Anna,99.0,"Drama,Mystery,Sci-Fi",6.5,19733,4357373,0,1200000,-3157373,-0.7246047102233387
Incendies,131.0,"Drama,Mystery,War",8.3,124156,6800000,6857096,16038343,9238343,1.3585798529411766
The Raven,110.0,"Crime,Mystery,Thriller",6.4,79578,26000000,16008272,30601801,4601801,0.17699234615384615
10 Cloverfield Lane,103.0,"Drama,Horror,Mystery",7.2,260383,5000000,72082999,108286422,103286422,20.6572844
Escape Plan,115.0,"Action,Crime,Mystery",6.7,211587,70000000,25135965,103735965,33735965,0.48194235714285716
Shutter Island,138.0,"Mystery,Thriller",8.1,1005960,80000000,128012934,299461782,219461782,2.743272275
Ouija,89.0,"Horror,Mystery,Thriller",4.5,44054,5000000,50856010,103300632,98300632,19.6601264
Oldboy,104.0,"Action,Drama,Mystery",5.8,63231,3000000,707391,6239723,3239723,1.0799076666666667
Rings,102.0,"Drama,Horror,Mystery",4.5,34151,25000000,27793018,82917283,57917283,2.31669132
Devil,80.0,"Horror,Mystery,Thriller",6.2,122080,10000000,33679655,63354114,53354114,5.3354114
Total Recall,118.0,"Action,Adventure,Mystery",6.3,228460,125000000,58877969,211856088,86856088,0.694848704
Super 8,112.0,"Mystery,Sci-Fi,Thriller",7.0,320575,50000000,127004179,257972745,207972745,4.1594549
The Ghost Writer,128.0,"Drama,Mystery,Thriller",7.2,148274,45000000,15541549,65532491,20532491,0.4562775777777778
Limitless,105.0,"Mystery,Sci-Fi,Thriller",7.4,492490,27000000,79249455,155564919,128564919,4.761663666666666
Unknown,113.0,"Action,Mystery,Thriller",6.9,235167,40000000,63686397,136123083,96123083,2.403077075
Buried,95.0,"Drama,Mystery,Thriller",7.0,139426,1987650,1044143,21270290,19282640,9.701225064774986
Lights Out,81.0,"Drama,Horror,Mystery",6.3,100650,5000000,67268835,148806510,143806510,28.761302
Paranormal Activity 3,83.0,"Horror,Mystery,Thriller",5.8,85689,5000000,104028807,207039844,202039844,40.4079688
It Comes at Night,91.0,"Horror,Mystery",6.2,69039,5000000,13985117,19720203,14720203,2.9440406
My Soul to Take,107.0,"Horror,Mystery,Thriller",4.8,18381,25000000,14744435,16727470,-8272530,-0.3309012
Salt,100.0,"Action,Mystery,Thriller",6.4,277204,130000000,118311368,290650494,160650494,1.2357730307692307
Chernobyl Diaries,86.0,"Horror,Mystery,Thriller",5.0,60304,1000000,18119640,42411721,41411721,41.411721
The Thing,103.0,"Horror,Mystery,Sci-Fi",6.2,111900,38000000,16999934,27573078,-10426922,-0.2743926842105263
Exeter,91.0,"Horror,Mystery,Thriller",4.5,5156,25000,0,489792,464792,18.59168
Lost River,95.0,"Drama,Fantasy,Mystery",5.8,15667,2000000,45431,2009644,9644,0.004822
The Girl on the Train,112.0,"Crime,Drama,Mystery",6.5,150977,45000000,75395035,174278214,129278214,2.8728492
Serenity,106.0,"Drama,Mystery,Sci-Fi",5.3,17904,39000000,25514517,40319440,1319440,0.03383179487179487
Before I Go to Sleep,92.0,"Drama,Horror,Mystery",6.3,64684,22000000,3242457,19563579,-2436421,-0.11074640909090909
Martha Marcy May Marlene,102.0,"Drama,Mystery,Thriller",6.9,45873,1000000,2981038,5438911,4438911,4.438911
The Boy,97.0,"Horror,Mystery,Thriller",6.0,68957,10000000,35819556,68220952,58220952,5.8220952
Abduction,106.0,"Action,Mystery,Thriller",5.1,72552,35000000,28087155,86648359,51648359,1.4756674
Apollo 18,86.0,"Horror,Mystery,Sci-Fi",5.2,51427,5000000,17686929,26517819,21517819,4.3035638
Divergent,139.0,"Action,Adventure,Mystery",6.7,399703,85000000,150947895,276014965,191014965,2.247234882352941
The Wall,108.0,"Drama,Fantasy,Mystery",6.8,5484,3000000,1803064,4495262,1495262,0.4984206666666667
Hereditary,127.0,"Drama,Horror,Mystery",7.3,151571,10000000,44069456,70133905,60133905,6.0133905
Dream House,84.0,"Drama,Mystery,Thriller",6.0,59714,50000000,21302340,41642166,-8357834,-0.16715668
While We're Young,97.0,"Comedy,Drama,Mystery",6.3,41327,10000000,7582065,17503828,7503828,0.7503828
Side Effects,106.0,"Crime,Drama,Mystery",7.1,168466,30000000,32172757,66742138,36742138,1.2247379333333333
Regression,106.0,"Crime,Horror,Mystery",5.7,33335,20000000,55039,15824374,-4175626,-0.2087813
Housebound,107.0,"Comedy,Horror,Mystery",6.8,29757,1500000,0,236863,-1263137,-0.8420913333333333
Evolution,81.0,"Drama,Mystery,Sci-Fi",6.0,5266,80000000,38311134,98341932,18341932,0.22927415
The Possession of Hannah Grace,86.0,"Horror,Mystery,Thriller",5.2,11629,6000000,14836174,42785387,36785387,6.130897833333333
Tinker Tailor Soldier Spy,122.0,"Drama,Mystery,Thriller",7.1,174890,21000000,24149393,81452811,60452811,2.8787052857142856
Cloud Atlas,172.0,"Action,Drama,Mystery",7.4,326473,102000000,27108272,130673154,28673154,0.28110935294117645
Red Riding Hood,100.0,"Fantasy,Horror,Mystery",5.5,102369,42000000,37662162,91678442,49678442,1.1828200476190476
Absentia,87.0,"Drama,Horror,Mystery",5.8,15507,70000,0,8555,-61445,-0.8777857142857143
Secret in Their Eyes,111.0,"Crime,Drama,Mystery",6.3,37455,20000000,20180155,32608019,12608019,0.63040095
Velvet Buzzsaw,113.0,"Horror,Mystery,Thriller",5.7,40213,21000000,0,0,-21000000,-1.0
Sound of My Voice,85.0,"Drama,Mystery,Sci-Fi",6.6,19387,135000,408015,429448,294448,2.181096296296296
The Snowman,119.0,"Crime,Drama,Mystery",5.1,47890,35000000,6670765,43226146,8226146,0.23503274285714285
Slender Man,93.0,"Horror,Mystery,Thriller",3.2,19650,10000000,30564825,51723644,41723644,4.1723644
Sinister 2,97.0,"Horror,Mystery,Thriller",5.3,41782,10000000,27740955,54104225,44104225,4.4104225
The Lazarus Effect,83.0,"Horror,Mystery,Sci-Fi",5.2,37675,5000000,25801570,38359310,33359310,6.671862
Insidious: The Last Key,103.0,"Horror,Mystery,Thriller",5.7,42154,10000000,67745330,167885588,157885588,15.7885588
Winter's Bone,100.0,"Drama,Mystery",7.2,127751,2000000,6531503,16131551,14131551,7.0657755
Prometheus,124.0,"Adventure,Mystery,Sci-Fi",7.0,538720,125000000,126477084,402448265,277448265,2.21958612
Arrival,116.0,"Drama,Mystery,Sci-Fi",7.9,515483,47000000,100546139,203127894,156127894,3.321870085106383
Veronica Mars,107.0,"Crime,Drama,Mystery",6.8,46751,6000000,3322127,3485383,-2514617,-0.4191028333333333
Jigsaw,92.0,"Crime,Horror,Mystery",5.8,57184,10000000,38052832,102445196,92445196,9.2445196
First Reformed,113.0,"Drama,Mystery,Thriller",7.1,33542,3500000,3448256,3874772,374772,0.10707771428571429
The Overnight,79.0,"Comedy,Mystery",6.1,14828,200000,1109808,1165996,965996,4.82998
The Witch,92.0,"Horror,Mystery",6.8,154278,3500000,25138705,40454520,36954520,10.558434285714286
Gone Girl,149.0,"Drama,Mystery,Thriller",8.1,761592,61000000,167767189,368567189,307567189,5.042085065573771
Project Almanac,106.0,"Drama,Mystery,Sci-Fi",6.4,71500,12000000,22348241,32909437,20909437,1.7424530833333334
Silent House,86.0,"Drama,Horror,Mystery",5.3,20831,2000000,12739737,16610760,14610760,7.30538
Paranormal Activity: The Marked Ones,84.0,"Horror,Mystery,Thriller",5.0,37147,5000000,32462372,90904854,85904854,17.1809708
The Signal,97.0,"Drama,Mystery,Sci-Fi",6.1,58407,4000000,600896,2665322,-1334678,-0.3336695
The Conjuring,112.0,"Horror,Mystery,Thriller",7.5,397233,20000000,137400141,318000141,298000141,14.90000705
Detention,93.0,"Comedy,Horror,Mystery",5.8,14221,10000000,0,0,-10000000,-1.0
Truth or Die,96.0,"Horror,Mystery",5.6,8123,1000000,0,0,-1000000,-1.0
Paranormal Activity 4,88.0,"Horror,Mystery,Thriller",4.6,58408,5000000,53900335,142817992,137817992,27.5635984
Murder on the Orient Express,114.0,"Crime,Drama,Mystery",6.5,178603,55000000,102826543,345922730,290922730,5.289504181818182
Strangerland,112.0,"Drama,Mystery,Thriller",5.2,7999,10000000,17472,161097,-9838903,-0.9838903
Parkland,93.0,"Drama,History,Mystery",6.4,14036,10000000,641439,1616353,-8383647,-0.8383647
Ex Machina,108.0,"Drama,Mystery,Sci-Fi",7.7,424542,13000000,25440971,38358392,25358392,1.9506455384615384
The Innkeepers,101.0,"Drama,Horror,Mystery",5.5,31089,750000,78396,1011535,261535,0.3487133333333333
Before I Fall,98.0,"Drama,Fantasy,Mystery",6.4,39282,5000000,12241072,18945682,13945682,2.7891364
Alex Cross,101.0,"Action,Crime,Mystery",5.1,30951,35000000,25888412,35426759,426759,0.012193114285714285
The Words,102.0,"Drama,Mystery,Romance",7.1,70308,6000000,11494838,16369708,10369708,1.7282846666666667
Shut In,91.0,"Drama,Mystery,Thriller",4.7,11030,10000000,6900335,11360665,1360665,0.1360665
The Frozen Ground,105.0,"Crime,Drama,Mystery",6.4,51915,19200000,0,5617460,-13582540,-0.7074239583333334
Oculus,104.0,"Horror,Mystery",6.5,106906,5000000,27695246,44115496,39115496,7.8230992
Annabelle,99.0,"Horror,Mystery,Thriller",5.4,122039,6500000,84273813,256862920,250362920,38.517372307692305
Bad Times at the El Royale,141.0,"Crime,Drama,Mystery",7.1,86318,32000000,17839115,29204379,-2795621,-0.08736315625
Midnight Special,112.0,"Action,Drama,Mystery",6.6,67921,18000000,3712282,7680250,-10319750,-0.5733194444444445
Get Out,104.0,"Horror,Mystery,Thriller",7.7,400474,5000000,176040665,255367951,250367951,50.0735902
Enter Nowhere,90.0,"Mystery,Sci-Fi,Thriller",6.6,7298,500000,0,0,-500000,-1.0
Happy Death Day,96.0,"Horror,Mystery,Thriller",6.5,87132,5000000,55683845,125010260,120010260,24.002052
Blade Runner 2049,164.0,"Drama,Mystery,Sci-Fi",8.0,376241,185000000,92054159,259357408,74357408,0.40193193513513514
Sinister,110.0,"Horror,Mystery,Thriller",6.8,198345,3000000,48086903,87727807,84727807,28.242602333333334
Deliver Us from Evil,118.0,"Horror,Mystery,Thriller",6.2,63793,30000000,30577122,87956618,57956618,1.9318872666666667
Hot Tub Time Machine 2,93.0,"Comedy,Mystery,Sci-Fi",5.1,34444,14000000,12314651,12826644,-1173356,-0.08381114285714286
"As Above, So Below",93.0,"Adventure,Horror,Mystery",6.2,66892,5000000,21222315,41824066,36824066,7.3648132
Trance,101.0,"Crime,Drama,Mystery",6.9,104951,16000000,2322593,22594052,6594052,0.41212825
Flatliners,109.0,"Drama,Horror,Mystery",5.2,33752,26000000,61308153,61308153,35308153,1.3580058846153846
The Gallows,81.0,"Horror,Mystery,Thriller",4.2,17763,100000,22764410,41656474,41556474,415.56474
Scream 4,111.0,"Horror,Mystery",6.2,118779,40000000,38180928,95989590,55989590,1.39973975
The Gift,108.0,"Drama,Mystery,Thriller",7.1,123834,10000000,12008642,44567606,34567606,3.4567606
Annabelle: Creation,109.0,"Horror,Mystery,Thriller",6.5,90402,15000000,102092201,305384865,290384865,19.358991
The Possession,92.0,"Horror,Mystery,Thriller",5.9,53649,14000000,49130588,82925064,68925064,4.9232188571428575
Paper Towns,109.0,"Comedy,Drama,Mystery",6.3,87742,12000000,32000304,85450484,73450484,6.120873666666666
The Maze Runner,113.0,"Action,Mystery,Sci-Fi",6.8,387038,34000000,102427862,348319861,314319861,9.244701794117647
The Hangover Part II,102.0,"Comedy,Mystery",6.5,432800,80000000,254464305,586464305,506464305,6.3308038125
Circle,87.0,"Drama,Mystery,Sci-Fi",6.0,30645,2000000,10024,10024,-1989976,-0.994988
Unsane,98.0,"Drama,Horror,Mystery",6.4,32049,1500000,7690044,14244931,12744931,8.496620666666667
Edge of Darkness,117.0,"Crime,Drama,Mystery",6.6,84753,60000000,43313890,82812456,22812456,0.3802076
The Girl with the Dragon Tattoo,158.0,"Crime,Drama,Mystery",7.8,387580,90000000,102515793,239373970,149373970,1.6597107777777778
Insidious,103.0,"Horror,Mystery,Thriller",6.9,254197,1500000,54009150,99870886,98370886,65.58059066666667
Unfriended: Dark Web,92.0,"Crime,Horror,Mystery",5.9,13822,1000000,8866745,16434588,15434588,15.434588
The Rite,114.0,"Drama,Horror,Mystery",6.0,85604,37000000,33047633,97143987,60143987,1.6255131621621621
The Invitation,100.0,"Drama,Horror,Mystery",6.7,70213,1000000,231738,354836,-645164,-0.645164
Misconduct,106.0,"Crime,Drama,Mystery",5.3,13550,11000000,0,2352511,-8647489,-0.7861353636363636
Happy Death Day 2U,100.0,"Drama,Horror,Mystery",6.3,27462,9000000,28051045,64179495,55179495,6.131055
Atomic Blonde,115.0,"Action,Mystery,Thriller",6.7,150407,30000000,51573925,98345423,68345423,2.2781807666666665
It Follows,100.0,"Horror,Mystery",6.9,182839,2000000,14674077,23250755,21250755,10.6253775
The Forest,93.0,"Horror,Mystery,Thriller",4.8,36423,10000000,26594261,40749230,30749230,3.074923
Prisoners,153.0,"Crime,Drama,Mystery",8.1,526273,46000000,61002302,113402302,67402302,1.4652674347826087
The Paperboy,107.0,"Crime,Drama,Mystery",5.8,33940,12500000,677200,4027663,-8472337,-0.67778696
Now You See Me,115.0,"Crime,Mystery,Thriller",7.3,553156,75000000,117723989,342769200,267769200,3.570256
Pet Sematary,101.0,"Horror,Mystery,Thriller",6.0,34472,21000000,54724696,109501146,88501146,4.214340285714286
Paranormal Activity: The Ghost Dimension,88.0,"Horror,Mystery,Thriller",4.6,22361,10000000,18297124,77959374,67959374,6.7959374
Devil's Due,89.0,"Horror,Mystery,Thriller",4.1,15502,7000000,15821461,36146087,29146087,4.163726714285715
The Visit,94.0,"Horror,Mystery,Thriller",6.2,102459,5000000,65206105,98677816,93677816,18.7355632
The Hateful Eight,168.0,"Crime,Drama,Mystery",7.8,434966,62000000,54117416,147864886,85864886,1.3849175161290324
Unfriended,83.0,"Horror,Mystery,Thriller",5.6,62043,1000000,32789645,64364198,63364198,63.364198
The Professor and the Madman,124.0,"Biography,Drama,Mystery",7.4,10383,25000000,0,5227233,-19772767,-0.79091068
Ouija: Origin of Evil,99.0,"Drama,Horror,Mystery",6.1,47099,9000000,35144505,81831866,72831866,8.092429555555556
Non-Stop,106.0,"Action,Mystery,Thriller",7.0,234717,50000000,91742160,222383055,172383055,3.4476611
Us,116.0,"Horror,Mystery,Thriller",7.1,102511,20000000,175006930,254210310,234210310,11.7105155
All Good Things,101.0,"Crime,Drama,Mystery",6.3,49684,20000000,582024,873617,-19126383,-0.95631915
We Need to Talk About Kevin,112.0,"Drama,Mystery,Thriller",7.5,123619,7000000,1738692,10765283,3765283,0.5378975714285714
Blair Witch,89.0,"Horror,Mystery,Thriller",5.0,36867,10000000,20777061,38985577,28985577,2.8985577
Suspiria,152.0,"Fantasy,Horror,Mystery",6.8,37360,20000000,2483472,7034615,-12965385,-0.64826925
