movie,runtime_minutes,genres,averagerating,numvotes,production_budget,domestic_gross,worldwide_gross,net_revenue,ROI%
Hereafter,129.0,"Drama,Fantasy,Romance",6.5,87288,50000000,32746941,108660270,58660270,1.1732054
Aloha,105.0,"Comedy,Drama,Romance",5.4,54646,37000000,21052030,25387091,-11612909,-0.3138624054054054
Sex and the City 2,146.0,"Comedy,Drama,Romance",4.4,69199,95000000,95347692,294680778,199680778,2.1019029263157893
Going the Distance,102.0,"Comedy,Romance",6.3,54421,32000000,17804299,43603990,11603990,0.3626246875
Remember Me,113.0,"Drama,Romance",7.1,129443,16000000,19068240,56506120,40506120,2.5316325
Another Earth,92.0,"Drama,Romance,Sci-Fi",7.0,85839,175000,1321194,2102779,1927779,11.01588
The Spectacular Now,95.0,"Comedy,Drama,Romance",7.1,133887,2500000,6852971,6916951,4416951,1.7667804
Eat Pray Love,133.0,"Drama,Romance",5.8,77709,60000000,80574010,206598789,146598789,2.44331315
The Bounty Hunter,110.0,"Action,Comedy,Romance",5.6,112444,45000000,67061228,135808837,90808837,2.0179741555555557
Never Let Me Go,103.0,"Drama,Romance,Sci-Fi",7.1,130084,15000000,2434652,11173718,-3826282,-0.25508546666666665
You Again,105.0,"Comedy,Family,Romance",5.8,46690,20000000,25702053,32838945,12838945,0.64194725
Beautiful Creatures,124.0,"Drama,Fantasy,Romance",6.2,79764,50000000,19452138,60282876,10282876,0.20565752
Blue Valentine,112.0,"Drama,Romance",7.4,170089,1000000,9737892,16566240,15566240,15.56624
One Day,107.0,"Drama,Romance",7.0,128094,15000000,13843771,59168692,44168692,2.9445794666666667
Tiny Furniture,98.0,"Comedy,Drama,Romance",6.2,13397,50000,391674,424149,374149,7.48298
Larry Crowne,98.0,"Comedy,Drama,Romance",6.1,58927,30000000,35608245,61449135,31449135,1.0483045
A Few Best Men,97.0,"Comedy,Romance",5.7,12069,15000000,0,17224539,2224539,0.1483026
The First Time,95.0,"Comedy,Drama,Romance",6.9,62589,2000000,17061,17061,-1982939,-0.9914695
The Big Wedding,89.0,"Comedy,Drama,Romance",5.6,44221,32500000,21819348,48425971,15925971,0.4900298769230769
Grace of Monaco,103.0,"Biography,Drama,Romance",5.7,16685,30000000,0,25199891,-4800109,-0.16000363333333334
You Will Meet a Tall Dark Stranger,98.0,"Comedy,Drama,Romance",6.3,41608,15000000,3247816,34247816,19247816,1.2831877333333332
Kites,123.0,"Action,Drama,Romance",6.1,11353,9200000,1685269,17155193,7955193,0.8646948913043478
Submarine,97.0,"Comedy,Drama,Romance",7.3,79810,1900000,467602,4581937,2681937,1.4115457894736843
Before We Go,95.0,"Comedy,Drama,Romance",6.8,45181,3000000,37151,483938,-2516062,-0.8386873333333333
Damsels in Distress,99.0,"Comedy,Drama,Romance",5.7,8794,3000000,1007535,1324299,-1675701,-0.558567
Cyrus,91.0,"Comedy,Drama,Romance",6.3,32457,7000000,7468936,10062896,3062896,0.4375565714285714
Upside Down,109.0,"Drama,Fantasy,Romance",6.4,66347,50000000,102118,26387039,-23612961,-0.47225922
MacGruber,90.0,"Action,Comedy,Romance",5.5,39782,10000000,8525600,8629895,-1370105,-0.1370105
Warm Bodies,98.0,"Comedy,Horror,Romance",6.9,208709,30000000,66380662,115121608,85121608,2.8373869333333332
Anna Karenina,129.0,"Drama,Romance",6.6,84668,49000000,12816367,71004627,22004627,0.44907402040816324
The Last Song,107.0,"Drama,Music,Romance",6.0,74914,20000000,62950384,92678948,72678948,3.6339474
The Great Gatsby,143.0,"Drama,Romance",7.3,433165,190000000,144840419,351040419,161040419,0.847581152631579
After,105.0,"Drama,Romance",5.6,7699,650000,0,0,-650000,-1.0
The Back-up Plan,104.0,"Comedy,Romance",5.4,46128,35000000,37490007,75281179,40281179,1.1508908285714285
The Vow,104.0,"Drama,Romance",6.8,173629,30000000,125014030,197618160,167618160,5.587272
By the Sea,122.0,"Drama,Romance",5.3,16206,20000000,538460,3727746,-16272254,-0.8136127
Home Again,97.0,"Comedy,Drama,Romance",5.8,22614,15000000,27020284,37336874,22336874,1.4891249333333334
The Kids Are All Right,106.0,"Comedy,Drama,Romance",7.0,120656,4000000,20811365,36275469,32275469,8.06886725
The Fault in Our Stars,126.0,"Drama,Romance",7.7,315135,12000000,124872350,307166834,295166834,24.597236166666665
Obvious Child,84.0,"Comedy,Drama,Romance",6.8,21536,1000000,3122616,3324070,2324070,2.32407
My Big Fat Greek Wedding 2,94.0,"Comedy,Romance",6.0,25933,18000000,59689605,92096558,74096558,4.116475444444444
Five Feet Apart,116.0,"Drama,Romance",7.2,10645,7000000,45729221,80504421,73504421,10.500631571428572
The Railway Man,116.0,"Biography,Drama,Romance",7.1,34586,18000000,4438438,23910210,5910210,0.328345
Two Night Stand,86.0,"Comedy,Romance",6.4,60510,1600000,15600,868081,-731919,-0.457449375
Dear White People,108.0,"Comedy,Drama,Romance",6.1,23321,1250000,4404154,5403771,4153771,3.3230168
Love the Coopers,107.0,"Comedy,Fantasy,Romance",5.8,18018,18000000,26302731,42227490,24227490,1.3459716666666666
Endless Love,104.0,"Drama,Romance",6.3,37869,20000000,23438250,34718173,14718173,0.73590865
Carol,118.0,"Drama,Romance",7.2,100680,11800000,12711491,42843521,31043521,2.6308068644067797
Collateral Beauty,97.0,"Drama,Romance",6.8,78764,36000000,31016021,85309093,49309093,1.3696970277777778
Leap Year,100.0,"Comedy,Romance",6.5,86125,19000000,25918920,32618920,13618920,0.7167852631578947
Easy A,92.0,"Comedy,Drama,Romance",7.1,330125,8000000,58401464,76200721,68200721,8.525090125
Bridesmaids,125.0,"Comedy,Romance",6.8,249501,32500000,169211718,289632023,257132023,7.911754553846154
Playing for Keeps,105.0,"Comedy,Romance,Sport",5.7,27389,35000000,2000000,2000000,-33000000,-0.9428571428571428
Midnight in Paris,94.0,"Comedy,Fantasy,Romance",7.7,356500,30000000,56816662,162502774,132502774,4.416759133333334
Tulip Fever,105.0,"Drama,History,Romance",6.2,15037,25000000,2455635,6792768,-18207232,-0.72828928
Womb,111.0,"Drama,Romance,Sci-Fi",6.4,12489,13000000,0,0,-13000000,-1.0
Think Like a Man,122.0,"Comedy,Romance",6.6,41043,12000000,91547205,113373764,101373764,8.447813666666667
Like Crazy,86.0,"Drama,Romance",6.7,55841,250000,3395391,3728400,3478400,13.9136
Step Up Revolution,99.0,"Drama,Music,Romance",6.5,51295,33000000,35074677,165552290,132552290,4.0167360606060605
Admission,107.0,"Comedy,Drama,Romance",5.7,31849,13000000,18007317,18733666,5733666,0.44105123076923075
The Space Between Us,120.0,"Adventure,Drama,Romance",6.4,41031,30000000,7885294,16481405,-13518595,-0.45061983333333333
Fruitvale Station,85.0,"Biography,Drama,Romance",7.5,68187,900000,16098998,17549645,16649645,18.499605555555554
Zookeeper,102.0,"Comedy,Family,Romance",5.2,52396,80000000,80360866,170805525,90805525,1.1350690625
Safe Haven,115.0,"Drama,Romance,Thriller",6.7,97055,28000000,71399120,94050951,66050951,2.358962535714286
Something Borrowed,112.0,"Comedy,Drama,Romance",5.9,54314,35000000,39046489,65084116,30084116,0.8595461714285715
It's Kind of a Funny Story,101.0,"Comedy,Drama,Romance",7.1,125583,8000000,6363628,6632950,-1367050,-0.17088125
Take Me Home Tonight,97.0,"Comedy,Drama,Romance",6.3,48393,19000000,6928068,7576604,-11423396,-0.6012313684210526
She's Out of My League,104.0,"Comedy,Romance",6.4,117245,20000000,32010860,48680977,28680977,1.43404885
Safety Not Guaranteed,86.0,"Comedy,Drama,Romance",7.0,111907,750000,4010957,4422318,3672318,4.896424
Tammy,97.0,"Comedy,Romance",4.9,44345,20000000,84525432,96407655,76407655,3.82038275
What's Your Number?,106.0,"Comedy,Romance",6.1,67922,20000000,14011084,30163785,10163785,0.50818925
Fifty Shades Darker,118.0,"Drama,Romance",4.6,81706,55000000,114434010,381398492,326398492,5.934518036363636
Why Did I Get Married Too?,121.0,"Comedy,Drama,Romance",4.6,8653,20000000,60095852,60831067,40831067,2.04155335
Weekend,97.0,"Drama,Romance",7.6,25424,190000,484592,1577585,1387585,7.303078947368421
Her,126.0,"Drama,Romance,Sci-Fi",8.0,467232,23000000,25568251,48163815,25163815,1.0940789130434783
What Men Want,117.0,"Comedy,Fantasy,Romance",4.9,10141,20000000,54611903,69911903,49911903,2.49559515
Hall Pass,105.0,"Comedy,Romance",5.9,113775,68000000,45060734,87173475,19173475,0.2819628676470588
Before Midnight,109.0,"Drama,Romance",7.9,123107,3000000,8110621,23251930,20251930,6.7506433333333336
"Everything, Everything",96.0,"Drama,Romance",6.4,26811,10000000,34121140,61603136,51603136,5.1603136
Acrimony,120.0,"Drama,Romance,Thriller",5.7,6119,20000000,43549096,46627836,26627836,1.3313918
I Feel Pretty,110.0,"Comedy,Romance",5.4,39936,32000000,48795601,91553797,59553797,1.86105615625
Valentine's Day,125.0,"Comedy,Romance",5.7,107171,52000000,110485654,217569328,165569328,3.1840255384615386
Beastly,86.0,"Drama,Fantasy,Romance",5.6,72599,17000000,27865571,38028230,21028230,1.236954705882353
The Five-Year Engagement,124.0,"Comedy,Romance",6.2,88469,30000000,28700285,61623819,31623819,1.0541273
Arthur,110.0,"Comedy,Romance",5.7,49013,40000000,33035397,47787943,7787943,0.194698575
A Better Life,98.0,"Drama,Romance",7.2,14602,10000000,1759252,1884251,-8115749,-0.8115749
On the Road,124.0,"Adventure,Drama,Romance",6.1,37886,25000000,720828,9313302,-15686698,-0.62746792
Me Before You,106.0,"Drama,Romance",7.4,174567,20000000,56245075,208265198,188265198,9.4132599
Silver Linings Playbook,122.0,"Comedy,Drama,Romance",7.7,621018,21000000,132092958,236412453,215412453,10.257735857142857
Labor Day,111.0,"Drama,Romance",6.9,39242,18000000,13371528,14189810,-3810190,-0.2116772222222222
Second Act,103.0,"Comedy,Drama,Romance",5.8,13109,15700000,39282227,63288854,47588854,3.0311371974522294
Forever My Girl,108.0,"Drama,Music,Romance",6.7,10316,3500000,16376066,16376066,12876066,3.678876
A Ghost Story,92.0,"Drama,Fantasy,Romance",6.8,46280,100000,1594798,2769782,2669782,26.69782
Accidental Love,100.0,"Comedy,Romance",4.1,7048,26000000,0,135436,-25864564,-0.9947909230769231
Date Night,88.0,"Comedy,Crime,Romance",6.3,144683,55000000,98711404,152269033,97269033,1.7685278727272726
Wanderlust,98.0,"Comedy,Romance",5.6,69081,32500000,17288155,24159934,-8340066,-0.2566174153846154
I Don't Know How She Does It,89.0,"Comedy,Romance",4.9,18552,24000000,9659074,24474463,474463,0.019769291666666668
The Giant Mechanical Man,95.0,"Comedy,Drama,Romance",6.7,8921,900000,7396,7396,-892604,-0.9917822222222222
Mike and Dave Need Wedding Dates,98.0,"Adventure,Comedy,Romance",6.0,74849,33000000,46009673,75898100,42898100,1.2999424242424242
"Love, Simon",110.0,"Comedy,Drama,Romance",7.6,81575,10000000,40826341,65520633,55520633,5.5520633
The Big Sick,120.0,"Comedy,Drama,Romance",7.6,104008,5000000,42872467,53972860,48972860,9.794572
About Last Night,100.0,"Comedy,Romance",6.1,21078,13000000,48637684,50445860,37445860,2.880450769230769
The Immigrant,120.0,"Drama,Romance",6.6,26618,16000000,2013456,7585011,-8414989,-0.5259368125
Brooklyn,117.0,"Drama,Romance",7.5,117021,11000000,38322743,62076141,51076141,4.643285545454545
They Came Together,83.0,"Comedy,Romance",5.5,19832,3000000,0,82780,-2917220,-0.9724066666666666
Book Club,104.0,"Comedy,Drama,Romance",6.1,18728,10000000,68566296,91113683,81113683,8.1113683
This Means War,103.0,"Action,Comedy,Romance",6.3,167438,65000000,54760791,156974557,91974557,1.4149931846153847
The To Do List,104.0,"Comedy,Romance",5.8,34524,1500000,3491669,4128828,2628828,1.752552
Beauty and the Beast,112.0,"Drama,Fantasy,Romance",6.4,18100,160000000,504014165,1259199706,1099199706,6.8699981625
Not Cool,93.0,"Comedy,Drama,Romance",4.5,5089,800000,35688,35688,-764312,-0.95539
Little Fockers,98.0,"Comedy,Romance",5.5,99222,100000000,148438600,310650574,210650574,2.10650574
Bad Teacher,92.0,"Comedy,Romance",5.7,181189,19000000,100292856,215448997,196448997,10.339420894736842
Just Wright,100.0,"Comedy,Romance,Sport",5.9,12466,12000000,21540363,21867665,9867665,0.8223054166666667
Overboard,112.0,"Comedy,Romance",5.9,25607,12000000,50316123,85369830,73369830,6.1141525
Fifty Shades of Grey,125.0,"Drama,Romance,Thriller",4.1,279126,40000000,166167230,570998101,530998101,13.274952525
Step Up 3D,107.0,"Drama,Music,Romance",6.2,53081,30000000,42400223,165889117,135889117,4.529637233333333
My Girlfriend's Boyfriend,84.0,"Comedy,Romance",5.8,5461,1400000,0,0,-1400000,-1.0
Beginners,105.0,"Comedy,Drama,Romance",7.2,83770,3200000,5790894,14314407,11114407,3.4732521875
Friends with Benefits,109.0,"Comedy,Romance",6.6,317338,35000000,55802754,146595891,111595891,3.1884540285714285
The Words,102.0,"Drama,Mystery,Romance",7.1,70308,6000000,11494838,16369708,10369708,1.7282846666666667
Enough Said,93.0,"Comedy,Drama,Romance",7.0,55698,8000000,17550872,25621449,17621449,2.202681125
Top Five,102.0,"Comedy,Romance",6.4,24744,12000000,25317379,26001741,14001741,1.16681175
Think Like a Man Too,106.0,"Comedy,Romance",5.8,18533,24000000,65028687,70027933,46027933,1.9178305416666668
Me and Earl and the Dying Girl,105.0,"Comedy,Drama,Romance",7.8,112627,8000000,6758416,9266180,1266180,0.1582725
Ain't Them Bodies Saints,96.0,"Crime,Drama,Romance",6.4,19464,5000000,391611,1075009,-3924991,-0.7849982
Trainwreck,125.0,"Comedy,Drama,Romance",6.2,121860,35000000,110212700,141123897,106123897,3.0321113428571427
Allied,124.0,"Action,Drama,Romance",7.1,125741,106000000,40098064,119266661,13266661,0.12515717924528302
American Honey,163.0,"Adventure,Drama,Romance",7.0,31663,3500000,663247,2611750,-888250,-0.2537857142857143
Fifty Shades Freed,105.0,"Drama,Romance,Thriller",4.5,43893,55000000,100407760,371350619,316350619,5.751829436363637
Paterson,118.0,"Comedy,Drama,Romance",7.4,55285,5000000,2141423,10727536,5727536,1.1455072
Loving,123.0,"Biography,Drama,Romance",7.0,28079,9000000,7710234,12898064,3898064,0.43311822222222224
Flipped,90.0,"Comedy,Drama,Romance",7.7,74937,14000000,1755212,4289993,-9710007,-0.6935719285714286
Biutiful,148.0,"Drama,Romance",7.5,80382,35000000,5101237,24687524,-10312476,-0.2946421714285714
The Three Musketeers,110.0,"Action,Adventure,Romance",5.8,98408,90000000,20377913,139877913,49877913,0.5541990333333333
The Longest Ride,123.0,"Drama,Romance",7.1,70327,34000000,37446117,63802928,29802928,0.8765567058823529
The Lobster,119.0,"Comedy,Drama,Romance",7.1,182622,4500000,9196278,18019834,13519834,3.0044075555555554
The Other Woman,109.0,"Comedy,Romance",6.0,122889,40000000,83911193,195111193,155111193,3.877779825
Frances Ha,86.0,"Comedy,Drama,Romance",7.4,60026,3000000,4067398,11262769,8262769,2.754256333333333
Gloria,110.0,"Comedy,Drama,Romance",6.8,7640,30000000,4167493,4967493,-25032507,-0.8344169
If Beale Street Could Talk,119.0,"Drama,Romance",7.2,25512,12000000,14915773,19859167,7859167,0.6549305833333333
Our Family Wedding,103.0,"Comedy,Romance",4.9,6417,14000000,20255281,21410546,7410546,0.5293247142857143
The Best Exotic Marigold Hotel,124.0,"Comedy,Drama,Romance",7.3,85811,10000000,46383639,134639780,124639780,12.463978
The Skeleton Twins,93.0,"Comedy,Drama,Romance",6.8,36793,1000000,5284309,5797192,4797192,4.797192
LOL,97.0,"Comedy,Drama,Romance",4.4,51424,11000000,0,10431506,-568494,-0.05168127272727273
That Awkward Moment,94.0,"Comedy,Romance",6.2,92148,8000000,26068955,53068955,45068955,5.633619375
The Giver,97.0,"Drama,Romance,Sci-Fi",6.5,104999,25000000,45090374,66540205,41540205,1.6616082
Blended,117.0,"Comedy,Romance",6.5,106491,45000000,46290741,127990741,82990741,1.8442386888888889
The Adjustment Bureau,106.0,"Romance,Sci-Fi,Thriller",7.1,227616,50200000,62495645,126931325,76731325,1.5285124501992031
What to Expect When You're Expecting,110.0,"Comedy,Drama,Romance",5.7,65890,37500000,41152203,88473016,50973016,1.3592804266666667
And So It Goes,94.0,"Comedy,Drama,Romance",5.8,11597,18000000,15160801,17920013,-79987,-0.004443722222222222
I Origins,106.0,"Drama,Romance,Sci-Fi",7.4,104718,1000000,336472,852399,-147601,-0.147601
Crazy Rich Asians,120.0,"Comedy,Romance",7.0,96617,30000000,174532921,238099711,208099711,6.936657033333334
Table 19,87.0,"Comedy,Drama,Romance",5.8,22751,5000000,3614896,4620399,-379601,-0.0759202
Vamps,92.0,"Comedy,Horror,Romance",5.2,8838,16000000,3361,94812,-15905188,-0.99407425
Albert Nobbs,113.0,"Drama,Romance",6.7,22213,7500000,3014696,8539003,1039003,0.13853373333333333
Water for Elephants,120.0,"Drama,Romance",6.9,105812,38000000,58709717,116809717,78809717,2.0739399210526317
50/50,100.0,"Comedy,Drama,Romance",7.7,300475,8000000,35016118,41334735,33334735,4.166841875
The Lucky One,101.0,"Drama,Romance",6.5,94359,25000000,60457138,96633833,71633833,2.86535332
Freeheld,103.0,"Biography,Drama,Romance",6.5,10534,7000000,546201,1732228,-5267772,-0.7525388571428572
Jab Tak Hai Jaan,176.0,"Drama,Romance",6.8,48364,9200000,3047539,5806666,-3393334,-0.36884065217391304
The Lunchbox,104.0,"Drama,Romance",7.8,42618,1700000,4231500,12231500,10531500,6.195
Highway,133.0,"Crime,Drama,Romance",7.7,23434,2000000,0,0,-2000000,-1.0
The Artist,100.0,"Comedy,Drama,Romance",7.9,217184,16000000,44667095,128256712,112256712,7.0160445
No Strings Attached,108.0,"Comedy,Romance",6.2,197663,25000000,70662220,149228078,124228078,4.96912312
A Dangerous Method,99.0,"Biography,Drama,Romance",6.4,93259,20000000,5702083,14807531,-5192469,-0.25962345
The Age of Adaline,112.0,"Drama,Fantasy,Romance",7.2,138924,30000000,42629776,68984536,38984536,1.2994845333333334
To Rome with Love,112.0,"Comedy,Music,Romance",6.3,79381,21500000,16684352,74326015,52826015,2.457023953488372
Much Ado About Nothing,109.0,"Comedy,Drama,Romance",7.2,15415,8000000,22549338,22549338,14549338,1.81866725
Long Shot,125.0,"Comedy,Romance",7.2,12814,40000000,30202860,43711031,3711031,0.092775775
The Theory of Everything,123.0,"Biography,Drama,Romance",7.7,361534,15000000,35893537,123327692,108327692,7.221846133333333
Killers,100.0,"Action,Comedy,Romance",5.4,82237,75000000,47059963,95572749,20572749,0.27430332
The Future,91.0,"Drama,Fantasy,Romance",6.2,7648,1000000,568662,1239174,239174,0.239174
Restless,91.0,"Drama,Romance",6.8,16736,8000000,163753,2772511,-5227489,-0.653436125
Drinking Buddies,90.0,"Comedy,Drama,Romance",6.1,53546,500000,343706,407100,-92900,-0.1858
The Diary of a Teenage Girl,102.0,"Comedy,Drama,Romance",6.9,27003,2000000,1477002,2279959,279959,0.1399795
The Best of Me,118.0,"Drama,Romance",6.7,59750,26000000,26766213,41059418,15059418,0.5792083846153846
Pitch Perfect,112.0,"Comedy,Music,Romance",7.2,256565,17000000,65001093,116044347,99044347,5.826138058823529
Don Jon,90.0,"Comedy,Drama,Romance",6.6,216350,5500000,24477704,41268579,35768579,6.503378
The Light Between Oceans,133.0,"Drama,Romance",7.2,46247,20000000,12545979,22281732,2281732,0.1140866
Morning Glory,107.0,"Comedy,Drama,Romance",6.5,67367,40000000,31011732,59795070,19795070,0.49487675
Hope Springs,100.0,"Comedy,Drama,Romance",6.3,38667,30000000,63536011,133085295,103085295,3.4361765
Amour,127.0,"Drama,Romance",7.9,84960,9700000,6738954,36787044,27087044,2.792478762886598
Wuthering Heights,129.0,"Drama,Romance",6.1,8549,8000000,100915,2721534,-5278466,-0.65980825
Passengers,116.0,"Drama,Romance,Sci-Fi",7.0,311083,110000000,100014699,302239672,192239672,1.7476333818181817
Charlie St. Cloud,99.0,"Drama,Fantasy,Romance",6.5,55016,44000000,31206263,48478084,4478084,0.10177463636363636
We Are Your Friends,96.0,"Drama,Music,Romance",6.2,32327,2000000,3591417,10153415,8153415,4.0767075
The Meddler,103.0,"Comedy,Drama,Romance",6.3,10629,3200000,4267219,5526942,2326942,0.727169375
The Switch,101.0,"Comedy,Drama,Romance",6.1,90661,19000000,27758465,49858465,30858465,1.6241297368421053
Dear John,108.0,"Drama,Romance,War",6.3,128657,25000000,80014842,142033509,117033509,4.68134036
Sex Tape,94.0,"Comedy,Romance",5.1,100520,40000000,38543473,126069509,86069509,2.151737725
Life as We Know It,114.0,"Comedy,Drama,Romance",6.6,113077,38000000,53374681,105887837,67887837,1.7865220263157895
The Art of Getting By,83.0,"Drama,Romance",6.6,53682,4000000,1430241,1989035,-2010965,-0.50274125
Bachelorette,87.0,"Comedy,Romance",5.3,43131,3000000,446770,12577401,9577401,3.192467
A Hologram for the King,98.0,"Comedy,Drama,Romance",6.1,36062,35000000,4212494,11846010,-23153990,-0.6615425714285714
Beyond the Lights,116.0,"Drama,Music,Romance",6.9,14122,7000000,14618727,14618727,7618727,1.0883895714285714
